AGCGGTCTTCC -> GCGGTCTTCCC
GCGGTCTTCCC -> CGGTCTTCCCA
CGGTCTTCCCA -> GGTCTTCCCAG
GGTCTTCCCAG -> GTCTTCCCAGA
GTCTTCCCAGA -> TCTTCCCAGAT
TCTTCCCAGAT -> CTTCCCAGATA
CTTCCCAGATA -> TTCCCAGATAT
TTCCCAGATAT -> TCCCAGATATA
TCCCAGATATA -> CCCAGATATAA
CCCAGATATAA -> CCAGATATAAA
CCAGATATAAA -> CAGATATAAAG
CAGATATAAAG -> AGATATAAAGC
AGATATAAAGC -> GATATAAAGCT
GATATAAAGCT -> ATATAAAGCTC
ATATAAAGCTC -> TATAAAGCTCC
TATAAAGCTCC -> ATAAAGCTCCT
ATAAAGCTCCT -> TAAAGCTCCTT
TAAAGCTCCTT -> AAAGCTCCTTG
AAAGCTCCTTG -> AAGCTCCTTGC
AAGCTCCTTGC -> AGCTCCTTGCG
AGCTCCTTGCG -> GCTCCTTGCGG
GCTCCTTGCGG -> CTCCTTGCGGG
CTCCTTGCGGG -> TCCTTGCGGGT
TCCTTGCGGGT -> CCTTGCGGGTG
CCTTGCGGGTG -> CTTGCGGGTGA
CTTGCGGGTGA -> TTGCGGGTGAC
TTGCGGGTGAC -> TGCGGGTGACT
TGCGGGTGACT -> GCGGGTGACTA
GCGGGTGACTA -> CGGGTGACTAG
CGGGTGACTAG -> GGGTGACTAGG
GGGTGACTAGG -> GGTGACTAGGA
GGTGACTAGGA -> GTGACTAGGAT
GTGACTAGGAT -> TGACTAGGATA
TGACTAGGATA -> GACTAGGATAG
GACTAGGATAG -> ACTAGGATAGA
ACTAGGATAGA -> CTAGGATAGAA
CTAGGATAGAA -> TAGGATAGAAA
TAGGATAGAAA -> AGGATAGAAAA
AGGATAGAAAA -> GGATAGAAAAC
GGATAGAAAAC -> GATAGAAAACA
GATAGAAAACA -> ATAGAAAACAC
ATAGAAAACAC -> TAGAAAACACT
TAGAAAACACT -> AGAAAACACTA
AGAAAACACTA -> GAAAACACTAG
GAAAACACTAG -> AAAACACTAGT
AAAACACTAGT -> AAACACTAGTG
AAACACTAGTG -> AACACTAGTGC
AACACTAGTGC -> ACACTAGTGCG
ACACTAGTGCG -> CACTAGTGCGG
CACTAGTGCGG -> ACTAGTGCGGT
ACTAGTGCGGT -> CTAGTGCGGTT
CTAGTGCGGTT -> TAGTGCGGTTT
TAGTGCGGTTT -> AGTGCGGTTTA
AGTGCGGTTTA -> GTGCGGTTTAC
GTGCGGTTTAC -> TGCGGTTTACT
TGCGGTTTACT -> GCGGTTTACTG
GCGGTTTACTG -> CGGTTTACTGG
CGGTTTACTGG -> GGTTTACTGGC
GGTTTACTGGC -> GTTTACTGGCA
GTTTACTGGCA -> TTTACTGGCAG
TTTACTGGCAG -> TTACTGGCAGG
TTACTGGCAGG -> TACTGGCAGGG
TACTGGCAGGG -> ACTGGCAGGGG
ACTGGCAGGGG -> CTGGCAGGGGT
CTGGCAGGGGT -> TGGCAGGGGTT
TGGCAGGGGTT -> GGCAGGGGTTG
GGCAGGGGTTG -> GCAGGGGTTGA
GCAGGGGTTGA -> CAGGGGTTGAT
CAGGGGTTGAT -> AGGGGTTGATG
AGGGGTTGATG -> GGGGTTGATGG
GGGGTTGATGG -> GGGTTGATGGC
GGGTTGATGGC -> GGTTGATGGCA
GGTTGATGGCA -> GTTGATGGCAT
GTTGATGGCAT -> TTGATGGCATT
TTGATGGCATT -> TGATGGCATTT
TGATGGCATTT -> GATGGCATTTC
GATGGCATTTC -> ATGGCATTTCA
ATGGCATTTCA -> TGGCATTTCAT
TGGCATTTCAT -> GGCATTTCATG
GGCATTTCATG -> GCATTTCATGA
GCATTTCATGA -> CATTTCATGAA
CATTTCATGAA -> ATTTCATGAAG
ATTTCATGAAG -> TTTCATGAAGT
TTTCATGAAGT -> TTCATGAAGTT
TTCATGAAGTT -> TCATGAAGTTC
TCATGAAGTTC -> CATGAAGTTCG
CATGAAGTTCG -> ATGAAGTTCGA
ATGAAGTTCGA -> TGAAGTTCGAG
TGAAGTTCGAG -> GAAGTTCGAGA
GAAGTTCGAGA -> AAGTTCGAGAA
AAGTTCGAGAA -> AGTTCGAGAAC
AGTTCGAGAAC -> GTTCGAGAACG
GTTCGAGAACG -> TTCGAGAACGA
TTCGAGAACGA -> TCGAGAACGAT
TCGAGAACGAT -> CGAGAACGATT
CGAGAACGATT -> GAGAACGATTG
GAGAACGATTG -> AGAACGATTGT
AGAACGATTGT -> GAACGATTGTT
GAACGATTGTT -> AACGATTGTTC
AACGATTGTTC -> ACGATTGTTCA
ACGATTGTTCA -> CGATTGTTCAC
CGATTGTTCAC -> GATTGTTCACG
GATTGTTCACG -> ATTGTTCACGC
ATTGTTCACGC -> TTGTTCACGCC
TTGTTCACGCC -> TGTTCACGCCA
TGTTCACGCCA -> GTTCACGCCAC
GTTCACGCCAC -> TTCACGCCACT
TTCACGCCACT -> TCACGCCACTA
TCACGCCACTA -> CACGCCACTAT
CACGCCACTAT -> ACGCCACTATG
ACGCCACTATG -> CGCCACTATGG
CGCCACTATGG -> GCCACTATGGG
GCCACTATGGG -> CCACTATGGGT
CCACTATGGGT -> CACTATGGGTT
CACTATGGGTT -> ACTATGGGTTG
ACTATGGGTTG -> CTATGGGTTGA
CTATGGGTTGA -> TATGGGTTGAG
TATGGGTTGAG -> ATGGGTTGAGA
ATGGGTTGAGA -> TGGGTTGAGAC
TGGGTTGAGAC -> GGGTTGAGACC
GGGTTGAGACC -> GGTTGAGACCA
GGTTGAGACCA -> GTTGAGACCAA
GTTGAGACCAA -> TTGAGACCAAC
TTGAGACCAAC -> TGAGACCAACT
TGAGACCAACT -> GAGACCAACTC
GAGACCAACTC -> AGACCAACTCG
AGACCAACTCG -> GACCAACTCGT
GACCAACTCGT -> ACCAACTCGTC
ACCAACTCGTC -> CCAACTCGTCA
CCAACTCGTCA -> CAACTCGTCAG
CAACTCGTCAG -> AACTCGTCAGG
AACTCGTCAGG -> ACTCGTCAGGG
ACTCGTCAGGG -> CTCGTCAGGGC
CTCGTCAGGGC -> TCGTCAGGGCC
TCGTCAGGGCC -> CGTCAGGGCCG
CGTCAGGGCCG -> GTCAGGGCCGA
GTCAGGGCCGA -> TCAGGGCCGAG
TCAGGGCCGAG -> CAGGGCCGAGC
CAGGGCCGAGC -> AGGGCCGAGCA
AGGGCCGAGCA -> GGGCCGAGCAT
GGGCCGAGCAT -> GGCCGAGCATT
GGCCGAGCATT -> GCCGAGCATTA
GCCGAGCATTA -> CCGAGCATTAT
CCGAGCATTAT -> CGAGCATTATT
CGAGCATTATT -> GAGCATTATTG
GAGCATTATTG -> AGCATTATTGA
AGCATTATTGA -> GCATTATTGAC
GCATTATTGAC -> CATTATTGACT
CATTATTGACT -> ATTATTGACTC
ATTATTGACTC -> TTATTGACTCT
TTATTGACTCT -> TATTGACTCTT
TATTGACTCTT -> ATTGACTCTTG
ATTGACTCTTG -> TTGACTCTTGC
TTGACTCTTGC -> TGACTCTTGCA
TGACTCTTGCA -> GACTCTTGCAG
GACTCTTGCAG -> ACTCTTGCAGT
ACTCTTGCAGT -> CTCTTGCAGTC
CTCTTGCAGTC -> TCTTGCAGTCT
TCTTGCAGTCT -> CTTGCAGTCTC
CTTGCAGTCTC -> TTGCAGTCTCT
TTGCAGTCTCT -> TGCAGTCTCTT
TGCAGTCTCTT -> GCAGTCTCTTA
GCAGTCTCTTA -> CAGTCTCTTAG
CAGTCTCTTAG -> AGTCTCTTAGT
AGTCTCTTAGT -> GTCTCTTAGTG
GTCTCTTAGTG -> TCTCTTAGTGT
TCTCTTAGTGT -> CTCTTAGTGTT
CTCTTAGTGTT -> TCTTAGTGTTA
TCTTAGTGTTA -> CTTAGTGTTAT
CTTAGTGTTAT -> TTAGTGTTATT
TTAGTGTTATT -> TAGTGTTATTA
TAGTGTTATTA -> AGTGTTATTAC
AGTGTTATTAC -> GTGTTATTACT
GTGTTATTACT -> TGTTATTACTA
TGTTATTACTA -> GTTATTACTAT
GTTATTACTAT -> TTATTACTATA
TTATTACTATA -> TATTACTATAA
TATTACTATAA -> ATTACTATAAT
ATTACTATAAT -> TTACTATAATG
TTACTATAATG -> TACTATAATGG
TACTATAATGG -> ACTATAATGGG
ACTATAATGGG -> CTATAATGGGT
CTATAATGGGT -> TATAATGGGTT
TATAATGGGTT -> ATAATGGGTTT
ATAATGGGTTT -> TAATGGGTTTT
TAATGGGTTTT -> AATGGGTTTTT
AATGGGTTTTT -> ATGGGTTTTTT
ATGGGTTTTTT -> TGGGTTTTTTC
TGGGTTTTTTC -> GGGTTTTTTCA
GGGTTTTTTCA -> GGTTTTTTCAC
GGTTTTTTCAC -> GTTTTTTCACA
GTTTTTTCACA -> TTTTTTCACAG
TTTTTTCACAG -> TTTTTCACAGG
TTTTTCACAGG -> TTTTCACAGGT
TTTTCACAGGT -> TTTCACAGGTC
TTTCACAGGTC -> TTCACAGGTCC
TTCACAGGTCC -> TCACAGGTCCA
TCACAGGTCCA -> CACAGGTCCAA
CACAGGTCCAA -> ACAGGTCCAAG
ACAGGTCCAAG -> CAGGTCCAAGT
CAGGTCCAAGT -> AGGTCCAAGTG
AGGTCCAAGTG -> GGTCCAAGTGG
GGTCCAAGTGG -> GTCCAAGTGGC
GTCCAAGTGGC -> TCCAAGTGGCT
TCCAAGTGGCT -> CCAAGTGGCTT
CCAAGTGGCTT -> CAAGTGGCTTT
CAAGTGGCTTT -> AAGTGGCTTTA
AAGTGGCTTTA -> AGTGGCTTTAA
AGTGGCTTTAA -> GTGGCTTTAAT
GTGGCTTTAAT -> TGGCTTTAATA
TGGCTTTAATA -> GGCTTTAATAC
GGCTTTAATAC -> GCTTTAATACA
GCTTTAATACA -> CTTTAATACAG
CTTTAATACAG -> TTTAATACAGC
TTTAATACAGC -> TTAATACAGCC
TTAATACAGCC -> TAATACAGCCG
TAATACAGCCG -> AATACAGCCGA
AATACAGCCGA -> ATACAGCCGAG
ATACAGCCGAG -> TACAGCCGAGA
TACAGCCGAGA -> ACAGCCGAGAC
ACAGCCGAGAC -> CAGCCGAGACT
CAGCCGAGACT -> AGCCGAGACTG
AGCCGAGACTG -> GCCGAGACTGC
GCCGAGACTGC -> CCGAGACTGCT
CCGAGACTGCT -> CGAGACTGCTT
CGAGACTGCTT -> GAGACTGCTTT
GAGACTGCTTT -> AGACTGCTTTT
AGACTGCTTTT -> GACTGCTTTTT
GACTGCTTTTT -> ACTGCTTTTTG
ACTGCTTTTTG -> CTGCTTTTTGG
CTGCTTTTTGG -> TGCTTTTTGGT
TGCTTTTTGGT -> GCTTTTTGGTA
GCTTTTTGGTA -> CTTTTTGGTAT
CTTTTTGGTAT -> TTTTTGGTATT
TTTTTGGTATT -> TTTTGGTATTC
TTTTGGTATTC -> TTTGGTATTCT
TTTGGTATTCT -> TTGGTATTCTT
TTGGTATTCTT -> TGGTATTCTTC
TGGTATTCTTC -> GGTATTCTTCG
GGTATTCTTCG -> GTATTCTTCGT
GTATTCTTCGT -> TATTCTTCGTG
TATTCTTCGTG -> ATTCTTCGTGG
ATTCTTCGTGG -> TTCTTCGTGGT
TTCTTCGTGGT -> TCTTCGTGGTA
TCTTCGTGGTA -> CTTCGTGGTAA
CTTCGTGGTAA -> TTCGTGGTAAG
TTCGTGGTAAG -> TCGTGGTAAGG
TCGTGGTAAGG -> CGTGGTAAGGT
CGTGGTAAGGT -> GTGGTAAGGTC
GTGGTAAGGTC -> TGGTAAGGTCT
TGGTAAGGTCT -> GGTAAGGTCTT
GGTAAGGTCTT -> GTAAGGTCTTT
GTAAGGTCTTT -> TAAGGTCTTTT
TAAGGTCTTTT -> AAGGTCTTTTC
AAGGTCTTTTC -> AGGTCTTTTCG
AGGTCTTTTCG -> GGTCTTTTCGA
GGTCTTTTCGA -> GTCTTTTCGAC
GTCTTTTCGAC -> TCTTTTCGACG
TCTTTTCGACG -> CTTTTCGACGC
CTTTTCGACGC -> TTTTCGACGCA
TTTTCGACGCA -> TTTCGACGCAC
TTTCGACGCAC -> TTCGACGCACT
TTCGACGCACT -> TCGACGCACTT
TCGACGCACTT -> CGACGCACTTT
CGACGCACTTT -> GACGCACTTTC
GACGCACTTTC -> ACGCACTTTCA
ACGCACTTTCA -> CGCACTTTCAT
CGCACTTTCAT -> GCACTTTCATC
GCACTTTCATC -> CACTTTCATCA
CACTTTCATCA -> ACTTTCATCAT
ACTTTCATCAT -> CTTTCATCATA
CTTTCATCATA -> TTTCATCATAT
TTTCATCATAT -> TTCATCATATA
TTCATCATATA -> TCATCATATAT
TCATCATATAT -> CATCATATATG
CATCATATATG -> ATCATATATGT
ATCATATATGT -> TCATATATGTT
TCATATATGTT -> CATATATGTTG
CATATATGTTG -> ATATATGTTGC
ATATATGTTGC -> TATATGTTGCG
TATATGTTGCG -> ATATGTTGCGT
ATATGTTGCGT -> TATGTTGCGTA
TATGTTGCGTA -> ATGTTGCGTAA
ATGTTGCGTAA -> TGTTGCGTAAA
TGTTGCGTAAA -> GTTGCGTAAAG
GTTGCGTAAAG -> TTGCGTAAAGC
TTGCGTAAAGC -> TGCGTAAAGCC
TGCGTAAAGCC -> GCGTAAAGCCT
GCGTAAAGCCT -> CGTAAAGCCTA
CGTAAAGCCTA -> GTAAAGCCTAA
GTAAAGCCTAA -> TAAAGCCTAAC
TAAAGCCTAAC -> AAAGCCTAACG
AAAGCCTAACG -> AAGCCTAACGA
AAGCCTAACGA -> AGCCTAACGAT
AGCCTAACGAT -> GCCTAACGATC
GCCTAACGATC -> CCTAACGATCG
CCTAACGATCG -> CTAACGATCGT
CTAACGATCGT -> TAACGATCGTC
TAACGATCGTC -> AACGATCGTCT
AACGATCGTCT -> ACGATCGTCTG
ACGATCGTCTG -> CGATCGTCTGA
CGATCGTCTGA -> GATCGTCTGAT
GATCGTCTGAT -> ATCGTCTGATT
ATCGTCTGATT -> TCGTCTGATTT
TCGTCTGATTT -> CGTCTGATTTT
CGTCTGATTTT -> GTCTGATTTTA
GTCTGATTTTA -> TCTGATTTTAT
TCTGATTTTAT -> CTGATTTTATT
CTGATTTTATT -> TGATTTTATTA
TGATTTTATTA -> GATTTTATTAT
GATTTTATTAT -> ATTTTATTATG
ATTTTATTATG -> TTTTATTATGG
TTTTATTATGG -> TTTATTATGGT
TTTATTATGGT -> TTATTATGGTC
TTATTATGGTC -> TATTATGGTCG
TATTATGGTCG -> ATTATGGTCGG
ATTATGGTCGG -> TTATGGTCGGG
TTATGGTCGGG -> TATGGTCGGGT
TATGGTCGGGT -> ATGGTCGGGTC
ATGGTCGGGTC -> TGGTCGGGTCA
TGGTCGGGTCA -> GGTCGGGTCAT
GGTCGGGTCAT -> GTCGGGTCATC
GTCGGGTCATC -> TCGGGTCATCT
TCGGGTCATCT -> CGGGTCATCTG
CGGGTCATCTG -> GGGTCATCTGT
GGGTCATCTGT -> GGTCATCTGTA
GGTCATCTGTA -> GTCATCTGTAC
GTCATCTGTAC -> TCATCTGTACT
TCATCTGTACT -> CATCTGTACTC
CATCTGTACTC -> ATCTGTACTCA
ATCTGTACTCA -> TCTGTACTCAT
TCTGTACTCAT -> CTGTACTCATC
CTGTACTCATC -> TGTACTCATCC
TGTACTCATCC -> GTACTCATCCG
GTACTCATCCG -> TACTCATCCGG
TACTCATCCGG -> ACTCATCCGGA
ACTCATCCGGA -> CTCATCCGGAT
CTCATCCGGAT -> TCATCCGGATC
TCATCCGGATC -> CATCCGGATCG
CATCCGGATCG -> ATCCGGATCGT
ATCCGGATCGT -> TCCGGATCGTA
TCCGGATCGTA -> CCGGATCGTAG
CCGGATCGTAG -> CGGATCGTAGT
CGGATCGTAGT -> GGATCGTAGTG
GGATCGTAGTG -> GATCGTAGTGC
GATCGTAGTGC -> ATCGTAGTGCC
ATCGTAGTGCC -> TCGTAGTGCCC
TCGTAGTGCCC -> CGTAGTGCCCC
CGTAGTGCCCC -> GTAGTGCCCCA
GTAGTGCCCCA -> TAGTGCCCCAG
TAGTGCCCCAG -> AGTGCCCCAGG
AGTGCCCCAGG -> GTGCCCCAGGT
GTGCCCCAGGT -> TGCCCCAGGTG
TGCCCCAGGTG -> GCCCCAGGTGA
GCCCCAGGTGA -> CCCCAGGTGAT
CCCCAGGTGAT -> CCCAGGTGATA
CCCAGGTGATA -> CCAGGTGATAT
CCAGGTGATAT -> CAGGTGATATT
CAGGTGATATT -> AGGTGATATTG
AGGTGATATTG -> GGTGATATTGT
GGTGATATTGT -> GTGATATTGTA
GTGATATTGTA -> TGATATTGTAG
TGATATTGTAG -> GATATTGTAGT
GATATTGTAGT -> ATATTGTAGTT
ATATTGTAGTT -> TATTGTAGTTG
TATTGTAGTTG -> ATTGTAGTTGC
ATTGTAGTTGC -> TTGTAGTTGCT
TTGTAGTTGCT -> TGTAGTTGCTG
TGTAGTTGCTG -> GTAGTTGCTGA
GTAGTTGCTGA -> TAGTTGCTGAT
TAGTTGCTGAT -> AGTTGCTGATA
AGTTGCTGATA -> GTTGCTGATAC
GTTGCTGATAC -> TTGCTGATACT
TTGCTGATACT -> TGCTGATACTT
TGCTGATACTT -> GCTGATACTTT
GCTGATACTTT -> CTGATACTTTT
CTGATACTTTT -> TGATACTTTTT
TGATACTTTTT -> GATACTTTTTG
GATACTTTTTG -> ATACTTTTTGA
ATACTTTTTGA -> TACTTTTTGAG
TACTTTTTGAG -> ACTTTTTGAGG
ACTTTTTGAGG -> CTTTTTGAGGT
CTTTTTGAGGT -> TTTTTGAGGTA
TTTTTGAGGTA -> TTTTGAGGTAC
TTTTGAGGTAC -> TTTGAGGTACA
TTTGAGGTACA -> TTGAGGTACAA
TTGAGGTACAA -> TGAGGTACAAG
TGAGGTACAAG -> GAGGTACAAGT
GAGGTACAAGT -> AGGTACAAGTT
AGGTACAAGTT -> GGTACAAGTTC
GGTACAAGTTC -> GTACAAGTTCA
GTACAAGTTCA -> TACAAGTTCAG
TACAAGTTCAG -> ACAAGTTCAGC
ACAAGTTCAGC -> CAAGTTCAGCG
CAAGTTCAGCG -> AAGTTCAGCGA
AAGTTCAGCGA -> AGTTCAGCGAT
AGTTCAGCGAT -> GTTCAGCGATT
GTTCAGCGATT -> TTCAGCGATTT
TTCAGCGATTT -> TCAGCGATTTC
TCAGCGATTTC -> CAGCGATTTCG
CAGCGATTTCG -> AGCGATTTCGC
AGCGATTTCGC -> GCGATTTCGCG
GCGATTTCGCG -> CGATTTCGCGC
CGATTTCGCGC -> GATTTCGCGCC
GATTTCGCGCC -> ATTTCGCGCCA
ATTTCGCGCCA -> TTTCGCGCCAG
TTTCGCGCCAG -> TTCGCGCCAGA
TTCGCGCCAGA -> TCGCGCCAGAC
TCGCGCCAGAC -> CGCGCCAGACA
CGCGCCAGACA -> GCGCCAGACAA
GCGCCAGACAA -> CGCCAGACAAT
CGCCAGACAAT -> GCCAGACAATA
GCCAGACAATA -> CCAGACAATAG
CCAGACAATAG -> CAGACAATAGC
CAGACAATAGC -> AGACAATAGCT
AGACAATAGCT -> GACAATAGCTT
GACAATAGCTT -> ACAATAGCTTC
ACAATAGCTTC -> CAATAGCTTCT
CAATAGCTTCT -> AATAGCTTCTC
AATAGCTTCTC -> ATAGCTTCTCA
ATAGCTTCTCA -> TAGCTTCTCAA
TAGCTTCTCAA -> AGCTTCTCAAG
AGCTTCTCAAG -> GCTTCTCAAGG
GCTTCTCAAGG -> CTTCTCAAGGA
CTTCTCAAGGA -> TTCTCAAGGAC
TTCTCAAGGAC -> TCTCAAGGACC
TCTCAAGGACC -> CTCAAGGACCA
CTCAAGGACCA -> TCAAGGACCAG
TCAAGGACCAG -> CAAGGACCAGT
CAAGGACCAGT -> AAGGACCAGTG
AAGGACCAGTG -> AGGACCAGTGC
AGGACCAGTGC -> GGACCAGTGCT
GGACCAGTGCT -> GACCAGTGCTA
GACCAGTGCTA -> ACCAGTGCTAT
ACCAGTGCTAT -> CCAGTGCTATA
CCAGTGCTATA -> CAGTGCTATAC
CAGTGCTATAC -> AGTGCTATACT
AGTGCTATACT -> GTGCTATACTC
GTGCTATACTC -> TGCTATACTCG
TGCTATACTCG -> GCTATACTCGG
GCTATACTCGG -> CTATACTCGGC
CTATACTCGGC -> TATACTCGGCG
TATACTCGGCG -> ATACTCGGCGT
ATACTCGGCGT -> TACTCGGCGTT
TACTCGGCGTT -> ACTCGGCGTTG
ACTCGGCGTTG -> CTCGGCGTTGG
CTCGGCGTTGG -> TCGGCGTTGGG
TCGGCGTTGGG -> CGGCGTTGGGG
CGGCGTTGGGG -> GGCGTTGGGGG
GGCGTTGGGGG -> GCGTTGGGGGT
GCGTTGGGGGT -> CGTTGGGGGTC
CGTTGGGGGTC -> GTTGGGGGTCA
GTTGGGGGTCA -> TTGGGGGTCAC
TTGGGGGTCAC -> TGGGGGTCACT
TGGGGGTCACT -> GGGGGTCACTA
GGGGGTCACTA -> GGGGTCACTAG
GGGGTCACTAG -> GGGTCACTAGC
GGGTCACTAGC -> GGTCACTAGCA
GGTCACTAGCA -> GTCACTAGCAC
GTCACTAGCAC -> TCACTAGCACC
TCACTAGCACC -> CACTAGCACCG
CACTAGCACCG -> ACTAGCACCGG
ACTAGCACCGG -> CTAGCACCGGA
CTAGCACCGGA -> TAGCACCGGAC
TAGCACCGGAC -> AGCACCGGACT
AGCACCGGACT -> GCACCGGACTC
GCACCGGACTC -> CACCGGACTCC
CACCGGACTCC -> ACCGGACTCCG
ACCGGACTCCG -> CCGGACTCCGT
CCGGACTCCGT -> CGGACTCCGTC
CGGACTCCGTC -> GGACTCCGTCC
GGACTCCGTCC -> GACTCCGTCCG
GACTCCGTCCG -> ACTCCGTCCGC
ACTCCGTCCGC -> CTCCGTCCGCA
CTCCGTCCGCA -> TCCGTCCGCAT
TCCGTCCGCAT -> CCGTCCGCATG
CCGTCCGCATG -> CGTCCGCATGC
CGTCCGCATGC -> GTCCGCATGCC
GTCCGCATGCC -> TCCGCATGCCA
TCCGCATGCCA -> CCGCATGCCAC
CCGCATGCCAC -> CGCATGCCACT
CGCATGCCACT -> GCATGCCACTG
GCATGCCACTG -> CATGCCACTGT
CATGCCACTGT -> ATGCCACTGTC
ATGCCACTGTC -> TGCCACTGTCA
TGCCACTGTCA -> GCCACTGTCAA
GCCACTGTCAA -> CCACTGTCAAC
CCACTGTCAAC -> CACTGTCAACA
CACTGTCAACA -> ACTGTCAACAG
ACTGTCAACAG -> CTGTCAACAGG
CTGTCAACAGG -> TGTCAACAGGG
TGTCAACAGGG -> GTCAACAGGGT
GTCAACAGGGT -> TCAACAGGGTG
TCAACAGGGTG -> CAACAGGGTGT
CAACAGGGTGT -> AACAGGGTGTG
AACAGGGTGTG -> ACAGGGTGTGC
ACAGGGTGTGC -> CAGGGTGTGCG
CAGGGTGTGCG -> AGGGTGTGCGC
AGGGTGTGCGC -> GGGTGTGCGCT
GGGTGTGCGCT -> GGTGTGCGCTT
GGTGTGCGCTT -> GTGTGCGCTTT
GTGTGCGCTTT -> TGTGCGCTTTA
TGTGCGCTTTA -> GTGCGCTTTAG
GTGCGCTTTAG -> TGCGCTTTAGG
TGCGCTTTAGG -> GCGCTTTAGGC
GCGCTTTAGGC -> CGCTTTAGGCG
CGCTTTAGGCG -> GCTTTAGGCGT
GCTTTAGGCGT -> CTTTAGGCGTT
CTTTAGGCGTT -> TTTAGGCGTTG
TTTAGGCGTTG -> TTAGGCGTTGA
TTAGGCGTTGA -> TAGGCGTTGAT
TAGGCGTTGAT -> AGGCGTTGATA
AGGCGTTGATA -> GGCGTTGATAT
GGCGTTGATAT -> GCGTTGATATC
GCGTTGATATC -> CGTTGATATCA
CGTTGATATCA -> GTTGATATCAA
GTTGATATCAA -> TTGATATCAAC
TTGATATCAAC -> TGATATCAACA
TGATATCAACA -> GATATCAACAA
GATATCAACAA -> ATATCAACAAA
ATATCAACAAA -> TATCAACAAAT
TATCAACAAAT -> ATCAACAAATC
ATCAACAAATC -> TCAACAAATCG
TCAACAAATCG -> CAACAAATCGG
CAACAAATCGG -> AACAAATCGGT
AACAAATCGGT -> ACAAATCGGTC
ACAAATCGGTC -> CAAATCGGTCG
CAAATCGGTCG -> AAATCGGTCGC
AAATCGGTCGC -> AATCGGTCGCT
AATCGGTCGCT -> ATCGGTCGCTT
ATCGGTCGCTT -> TCGGTCGCTTA
TCGGTCGCTTA -> CGGTCGCTTAT
CGGTCGCTTAT -> GGTCGCTTATG
GGTCGCTTATG -> GTCGCTTATGA
GTCGCTTATGA -> TCGCTTATGAA
TCGCTTATGAA -> CGCTTATGAAG
CGCTTATGAAG -> GCTTATGAAGG
GCTTATGAAGG -> CTTATGAAGGA
CTTATGAAGGA -> TTATGAAGGAC
TTATGAAGGAC -> TATGAAGGACT
TATGAAGGACT -> ATGAAGGACTC
ATGAAGGACTC -> TGAAGGACTCT
TGAAGGACTCT -> GAAGGACTCTT
GAAGGACTCTT -> AAGGACTCTTT
AAGGACTCTTT -> AGGACTCTTTT
AGGACTCTTTT -> GGACTCTTTTC
GGACTCTTTTC -> GACTCTTTTCA
GACTCTTTTCA -> ACTCTTTTCAG
ACTCTTTTCAG -> CTCTTTTCAGG
CTCTTTTCAGG -> TCTTTTCAGGC
TCTTTTCAGGC -> CTTTTCAGGCA
CTTTTCAGGCA -> TTTTCAGGCAT
TTTTCAGGCAT -> TTTCAGGCATC
TTTCAGGCATC -> TTCAGGCATCA
TTCAGGCATCA -> TCAGGCATCAG
TCAGGCATCAG -> CAGGCATCAGA
CAGGCATCAGA -> AGGCATCAGAT
AGGCATCAGAT -> GGCATCAGATG
GGCATCAGATG -> GCATCAGATGG
GCATCAGATGG -> CATCAGATGGG
CATCAGATGGG -> ATCAGATGGGG
ATCAGATGGGG -> TCAGATGGGGT
TCAGATGGGGT -> CAGATGGGGTT
CAGATGGGGTT -> AGATGGGGTTT
AGATGGGGTTT -> GATGGGGTTTC
GATGGGGTTTC -> ATGGGGTTTCA
ATGGGGTTTCA -> TGGGGTTTCAG
TGGGGTTTCAG -> GGGGTTTCAGT
GGGGTTTCAGT -> GGGTTTCAGTG
GGGTTTCAGTG -> GGTTTCAGTGG
GGTTTCAGTGG -> GTTTCAGTGGC
GTTTCAGTGGC -> TTTCAGTGGCC
TTTCAGTGGCC -> TTCAGTGGCCC
TTCAGTGGCCC -> TCAGTGGCCCA
TCAGTGGCCCA -> CAGTGGCCCAC
CAGTGGCCCAC -> AGTGGCCCACT
AGTGGCCCACT -> GTGGCCCACTT
GTGGCCCACTT -> TGGCCCACTTA
TGGCCCACTTA -> GGCCCACTTAA
GGCCCACTTAA -> GCCCACTTAAT
GCCCACTTAAT -> CCCACTTAATA
CCCACTTAATA -> CCACTTAATAA
CCACTTAATAA -> CACTTAATAAC
CACTTAATAAC -> ACTTAATAACA
ACTTAATAACA -> CTTAATAACAT
CTTAATAACAT -> TTAATAACATG
TTAATAACATG -> TAATAACATGA
TAATAACATGA -> AATAACATGAT
AATAACATGAT -> ATAACATGATG
ATAACATGATG -> TAACATGATGG
TAACATGATGG -> AACATGATGGT
AACATGATGGT -> ACATGATGGTC
ACATGATGGTC -> CATGATGGTCC
CATGATGGTCC -> ATGATGGTCCA
ATGATGGTCCA -> TGATGGTCCAA
TGATGGTCCAA -> GATGGTCCAAT
GATGGTCCAAT -> ATGGTCCAATG
ATGGTCCAATG -> TGGTCCAATGA
TGGTCCAATGA -> GGTCCAATGAG
GGTCCAATGAG -> GTCCAATGAGT
GTCCAATGAGT -> TCCAATGAGTC
TCCAATGAGTC -> CCAATGAGTCG
CCAATGAGTCG -> CAATGAGTCGA
CAATGAGTCGA -> AATGAGTCGAA
AATGAGTCGAA -> ATGAGTCGAAT
ATGAGTCGAAT -> TGAGTCGAATG
TGAGTCGAATG -> GAGTCGAATGG
GAGTCGAATGG -> AGTCGAATGGG
AGTCGAATGGG -> GTCGAATGGGC
GTCGAATGGGC -> TCGAATGGGCA
TCGAATGGGCA -> CGAATGGGCAT
CGAATGGGCAT -> GAATGGGCATG
GAATGGGCATG -> AATGGGCATGC
AATGGGCATGC -> ATGGGCATGCC
ATGGGCATGCC -> TGGGCATGCCT
TGGGCATGCCT -> GGGCATGCCTT
GGGCATGCCTT -> GGCATGCCTTG
GGCATGCCTTG -> GCATGCCTTGG
GCATGCCTTGG -> CATGCCTTGGA
CATGCCTTGGA -> ATGCCTTGGAG
ATGCCTTGGAG -> TGCCTTGGAGC
TGCCTTGGAGC -> GCCTTGGAGCC
GCCTTGGAGCC -> CCTTGGAGCCT
CCTTGGAGCCT -> CTTGGAGCCTA
CTTGGAGCCTA -> TTGGAGCCTAA
TTGGAGCCTAA -> TGGAGCCTAAA
TGGAGCCTAAA -> GGAGCCTAAAC
GGAGCCTAAAC -> GAGCCTAAACT
GAGCCTAAACT -> AGCCTAAACTG
AGCCTAAACTG -> GCCTAAACTGC
GCCTAAACTGC -> CCTAAACTGCT
CCTAAACTGCT -> CTAAACTGCTC
CTAAACTGCTC -> TAAACTGCTCA
TAAACTGCTCA -> AAACTGCTCAT
AAACTGCTCAT -> AACTGCTCATG
AACTGCTCATG -> ACTGCTCATGC
ACTGCTCATGC -> CTGCTCATGCG
CTGCTCATGCG -> TGCTCATGCGT
TGCTCATGCGT -> GCTCATGCGTG
GCTCATGCGTG -> CTCATGCGTGC
CTCATGCGTGC -> TCATGCGTGCA
TCATGCGTGCA -> CATGCGTGCAG
CATGCGTGCAG -> ATGCGTGCAGC
ATGCGTGCAGC -> TGCGTGCAGCC
TGCGTGCAGCC -> GCGTGCAGCCA
GCGTGCAGCCA -> CGTGCAGCCAT
CGTGCAGCCAT -> GTGCAGCCATG
GTGCAGCCATG -> TGCAGCCATGC
TGCAGCCATGC -> GCAGCCATGCT
GCAGCCATGCT -> CAGCCATGCTT
CAGCCATGCTT -> AGCCATGCTTA
AGCCATGCTTA -> GCCATGCTTAG
GCCATGCTTAG -> CCATGCTTAGG
CCATGCTTAGG -> CATGCTTAGGA
CATGCTTAGGA -> ATGCTTAGGAC
ATGCTTAGGAC -> TGCTTAGGACT
TGCTTAGGACT -> GCTTAGGACTG
GCTTAGGACTG -> CTTAGGACTGA
CTTAGGACTGA -> TTAGGACTGAC
TTAGGACTGAC -> TAGGACTGACA
TAGGACTGACA -> AGGACTGACAT
AGGACTGACAT -> GGACTGACATT
GGACTGACATT -> GACTGACATTT
GACTGACATTT -> ACTGACATTTC
ACTGACATTTC -> CTGACATTTCG
CTGACATTTCG -> TGACATTTCGT
TGACATTTCGT -> GACATTTCGTA
GACATTTCGTA -> ACATTTCGTAC
ACATTTCGTAC -> CATTTCGTACG
CATTTCGTACG -> ATTTCGTACGC
ATTTCGTACGC -> TTTCGTACGCA
TTTCGTACGCA -> TTCGTACGCAG
TTCGTACGCAG -> TCGTACGCAGC
TCGTACGCAGC -> CGTACGCAGCG
CGTACGCAGCG -> GTACGCAGCGG
GTACGCAGCGG -> TACGCAGCGGA
TACGCAGCGGA -> ACGCAGCGGAG
ACGCAGCGGAG -> CGCAGCGGAGT
CGCAGCGGAGT -> GCAGCGGAGTA
GCAGCGGAGTA -> CAGCGGAGTAC
CAGCGGAGTAC -> AGCGGAGTACA
AGCGGAGTACA -> GCGGAGTACAC
GCGGAGTACAC -> CGGAGTACACT
CGGAGTACACT -> GGAGTACACTA
GGAGTACACTA -> GAGTACACTAC
GAGTACACTAC -> AGTACACTACC
AGTACACTACC -> GTACACTACCC
GTACACTACCC -> TACACTACCCT
TACACTACCCT -> ACACTACCCTC
ACACTACCCTC -> CACTACCCTCC
CACTACCCTCC -> ACTACCCTCCT
ACTACCCTCCT -> CTACCCTCCTG
CTACCCTCCTG -> TACCCTCCTGA
TACCCTCCTGA -> ACCCTCCTGAG
ACCCTCCTGAG -> CCCTCCTGAGA
CCCTCCTGAGA -> CCTCCTGAGAG
CCTCCTGAGAG -> CTCCTGAGAGA
CTCCTGAGAGA -> TCCTGAGAGAG
TCCTGAGAGAG -> CCTGAGAGAGC
CCTGAGAGAGC -> CTGAGAGAGCC
CTGAGAGAGCC -> TGAGAGAGCCA
TGAGAGAGCCA -> GAGAGAGCCAC
GAGAGAGCCAC -> AGAGAGCCACC
AGAGAGCCACC -> GAGAGCCACCC
GAGAGCCACCC -> AGAGCCACCCT
AGAGCCACCCT -> GAGCCACCCTT
GAGCCACCCTT -> AGCCACCCTTC
AGCCACCCTTC -> GCCACCCTTCG
GCCACCCTTCG -> CCACCCTTCGG
CCACCCTTCGG -> CACCCTTCGGC
CACCCTTCGGC -> ACCCTTCGGCG
ACCCTTCGGCG -> CCCTTCGGCGC
CCCTTCGGCGC -> CCTTCGGCGCT
CCTTCGGCGCT -> CTTCGGCGCTC
CTTCGGCGCTC -> TTCGGCGCTCA
TTCGGCGCTCA -> TCGGCGCTCAC
TCGGCGCTCAC -> CGGCGCTCACG
CGGCGCTCACG -> GGCGCTCACGA
GGCGCTCACGA -> GCGCTCACGAG
GCGCTCACGAG -> CGCTCACGAGG
CGCTCACGAGG -> GCTCACGAGGT
GCTCACGAGGT -> CTCACGAGGTG
CTCACGAGGTG -> TCACGAGGTGA
TCACGAGGTGA -> CACGAGGTGAG
CACGAGGTGAG -> ACGAGGTGAGA
ACGAGGTGAGA -> CGAGGTGAGAT
CGAGGTGAGAT -> GAGGTGAGATT
GAGGTGAGATT -> AGGTGAGATTT
AGGTGAGATTT -> GGTGAGATTTG
GGTGAGATTTG -> GTGAGATTTGC
GTGAGATTTGC -> TGAGATTTGCC
TGAGATTTGCC -> GAGATTTGCCA
GAGATTTGCCA -> AGATTTGCCAA
AGATTTGCCAA -> GATTTGCCAAT
GATTTGCCAAT -> ATTTGCCAATT
ATTTGCCAATT -> TTTGCCAATTA
TTTGCCAATTA -> TTGCCAATTAG
TTGCCAATTAG -> TGCCAATTAGC
TGCCAATTAGC -> GCCAATTAGCC
GCCAATTAGCC -> CCAATTAGCCT
CCAATTAGCCT -> CAATTAGCCTG
CAATTAGCCTG -> AATTAGCCTGT
AATTAGCCTGT -> ATTAGCCTGTA
ATTAGCCTGTA -> TTAGCCTGTAT
TTAGCCTGTAT -> TAGCCTGTATA
TAGCCTGTATA -> AGCCTGTATAA
AGCCTGTATAA -> GCCTGTATAAT
GCCTGTATAAT -> CCTGTATAATC
CCTGTATAATC -> CTGTATAATCT
CTGTATAATCT -> TGTATAATCTC
TGTATAATCTC -> GTATAATCTCA
GTATAATCTCA -> TATAATCTCAG
TATAATCTCAG -> ATAATCTCAGC
ATAATCTCAGC -> TAATCTCAGCG
TAATCTCAGCG -> AATCTCAGCGC
AATCTCAGCGC -> ATCTCAGCGCG
ATCTCAGCGCG -> TCTCAGCGCGG
TCTCAGCGCGG -> CTCAGCGCGGA
CTCAGCGCGGA -> TCAGCGCGGAA
TCAGCGCGGAA -> CAGCGCGGAAG
CAGCGCGGAAG -> AGCGCGGAAGA
AGCGCGGAAGA -> GCGCGGAAGAA
GCGCGGAAGAA -> CGCGGAAGAAA
CGCGGAAGAAA -> GCGGAAGAAAA
GCGGAAGAAAA -> CGGAAGAAAAT
CGGAAGAAAAT -> GGAAGAAAATT
GGAAGAAAATT -> GAAGAAAATTA
GAAGAAAATTA -> AAGAAAATTAG
AAGAAAATTAG -> AGAAAATTAGG
AGAAAATTAGG -> GAAAATTAGGA
GAAAATTAGGA -> AAAATTAGGAT
AAAATTAGGAT -> AAATTAGGATC
AAATTAGGATC -> AATTAGGATCA
AATTAGGATCA -> ATTAGGATCAG
ATTAGGATCAG -> TTAGGATCAGC
TTAGGATCAGC -> TAGGATCAGCA
TAGGATCAGCA -> AGGATCAGCAG
AGGATCAGCAG -> GGATCAGCAGT
GGATCAGCAGT -> GATCAGCAGTA
GATCAGCAGTA -> ATCAGCAGTAT
ATCAGCAGTAT -> TCAGCAGTATC
TCAGCAGTATC -> CAGCAGTATCT
CAGCAGTATCT -> AGCAGTATCTA
AGCAGTATCTA -> GCAGTATCTAC
GCAGTATCTAC -> CAGTATCTACC
CAGTATCTACC -> AGTATCTACCA
AGTATCTACCA -> GTATCTACCAC
GTATCTACCAC -> TATCTACCACG
TATCTACCACG -> ATCTACCACGT
ATCTACCACGT -> TCTACCACGTA
TCTACCACGTA -> CTACCACGTAA
CTACCACGTAA -> TACCACGTAAT
TACCACGTAAT -> ACCACGTAATC
ACCACGTAATC -> CCACGTAATCG
CCACGTAATCG -> CACGTAATCGG
CACGTAATCGG -> ACGTAATCGGG
ACGTAATCGGG -> CGTAATCGGGG
CGTAATCGGGG -> GTAATCGGGGG
GTAATCGGGGG -> TAATCGGGGGG
TAATCGGGGGG -> AATCGGGGGGA
AATCGGGGGGA -> ATCGGGGGGAA
ATCGGGGGGAA -> TCGGGGGGAAA
TCGGGGGGAAA -> CGGGGGGAAAT
CGGGGGGAAAT -> GGGGGGAAATT
GGGGGGAAATT -> GGGGGAAATTG
GGGGGAAATTG -> GGGGAAATTGT
GGGGAAATTGT -> GGGAAATTGTT
GGGAAATTGTT -> GGAAATTGTTC
GGAAATTGTTC -> GAAATTGTTCA
GAAATTGTTCA -> AAATTGTTCAA
AAATTGTTCAA -> AATTGTTCAAC
AATTGTTCAAC -> ATTGTTCAACC
ATTGTTCAACC -> TTGTTCAACCT
TTGTTCAACCT -> TGTTCAACCTG
TGTTCAACCTG -> GTTCAACCTGT
GTTCAACCTGT -> TTCAACCTGTC
TTCAACCTGTC -> TCAACCTGTCG
TCAACCTGTCG -> CAACCTGTCGG
CAACCTGTCGG -> AACCTGTCGGG
AACCTGTCGGG -> ACCTGTCGGGC
ACCTGTCGGGC -> CCTGTCGGGCA
CCTGTCGGGCA -> CTGTCGGGCAA
CTGTCGGGCAA -> TGTCGGGCAAT
TGTCGGGCAAT -> GTCGGGCAATC
GTCGGGCAATC -> TCGGGCAATCG
TCGGGCAATCG -> CGGGCAATCGC
CGGGCAATCGC -> GGGCAATCGCG
GGGCAATCGCG -> GGCAATCGCGA
GGCAATCGCGA -> GCAATCGCGAT
GCAATCGCGAT -> CAATCGCGATT
CAATCGCGATT -> AATCGCGATTA
AATCGCGATTA -> ATCGCGATTAC
ATCGCGATTAC -> TCGCGATTACC
TCGCGATTACC -> CGCGATTACCG
CGCGATTACCG -> GCGATTACCGG
GCGATTACCGG -> CGATTACCGGC
CGATTACCGGC -> GATTACCGGCA
GATTACCGGCA -> ATTACCGGCAA
ATTACCGGCAA -> TTACCGGCAAC
TTACCGGCAAC -> TACCGGCAACG
TACCGGCAACG -> ACCGGCAACGC
ACCGGCAACGC -> CCGGCAACGCG
CCGGCAACGCG -> CGGCAACGCGT
CGGCAACGCGT -> GGCAACGCGTT
GGCAACGCGTT -> GCAACGCGTTG
GCAACGCGTTG -> CAACGCGTTGT
CAACGCGTTGT -> AACGCGTTGTA
AACGCGTTGTA -> ACGCGTTGTAT
ACGCGTTGTAT -> CGCGTTGTATC
CGCGTTGTATC -> GCGTTGTATCC
GCGTTGTATCC -> CGTTGTATCCT
CGTTGTATCCT -> GTTGTATCCTA
GTTGTATCCTA -> TTGTATCCTAT
TTGTATCCTAT -> TGTATCCTATT
TGTATCCTATT -> GTATCCTATTT
GTATCCTATTT -> TATCCTATTTA
TATCCTATTTA -> ATCCTATTTAG
ATCCTATTTAG -> TCCTATTTAGC
TCCTATTTAGC -> CCTATTTAGCG
CCTATTTAGCG -> CTATTTAGCGT
CTATTTAGCGT -> TATTTAGCGTT
TATTTAGCGTT -> ATTTAGCGTTG
ATTTAGCGTTG -> TTTAGCGTTGT
TTTAGCGTTGT -> TTAGCGTTGTC
TTAGCGTTGTC -> TAGCGTTGTCA
TAGCGTTGTCA -> AGCGTTGTCAT
AGCGTTGTCAT -> GCGTTGTCATA
GCGTTGTCATA -> CGTTGTCATAC
CGTTGTCATAC -> GTTGTCATACT
GTTGTCATACT -> TTGTCATACTC
TTGTCATACTC -> TGTCATACTCT
TGTCATACTCT -> GTCATACTCTG
GTCATACTCTG -> TCATACTCTGC
TCATACTCTGC -> CATACTCTGCT
CATACTCTGCT -> ATACTCTGCTT
ATACTCTGCTT -> TACTCTGCTTT
TACTCTGCTTT -> ACTCTGCTTTA
ACTCTGCTTTA -> CTCTGCTTTAT
CTCTGCTTTAT -> TCTGCTTTATA
TCTGCTTTATA -> CTGCTTTATAT
CTGCTTTATAT -> TGCTTTATATG
TGCTTTATATG -> GCTTTATATGC
GCTTTATATGC -> CTTTATATGCA
CTTTATATGCA -> TTTATATGCAG
TTTATATGCAG -> TTATATGCAGG
TTATATGCAGG -> TATATGCAGGA
TATATGCAGGA -> ATATGCAGGAT
ATATGCAGGAT -> TATGCAGGATC
TATGCAGGATC -> ATGCAGGATCA
ATGCAGGATCA -> TGCAGGATCAT
TGCAGGATCAT -> GCAGGATCATG
GCAGGATCATG -> CAGGATCATGG
CAGGATCATGG -> AGGATCATGGT
AGGATCATGGT -> GGATCATGGTT
GGATCATGGTT -> GATCATGGTTG
GATCATGGTTG -> ATCATGGTTGG
ATCATGGTTGG -> TCATGGTTGGG
TCATGGTTGGG -> CATGGTTGGGC
CATGGTTGGGC -> ATGGTTGGGCC
ATGGTTGGGCC -> TGGTTGGGCCA
TGGTTGGGCCA -> GGTTGGGCCAG
GGTTGGGCCAG -> GTTGGGCCAGT
GTTGGGCCAGT -> TTGGGCCAGTA
TTGGGCCAGTA -> TGGGCCAGTAT
TGGGCCAGTAT -> GGGCCAGTATT
GGGCCAGTATT -> GGCCAGTATTG
GGCCAGTATTG -> GCCAGTATTGG
GCCAGTATTGG -> CCAGTATTGGC
CCAGTATTGGC -> CAGTATTGGCC
CAGTATTGGCC -> AGTATTGGCCG
AGTATTGGCCG -> GTATTGGCCGC
GTATTGGCCGC -> TATTGGCCGCG
TATTGGCCGCG -> ATTGGCCGCGA
ATTGGCCGCGA -> TTGGCCGCGAG
TTGGCCGCGAG -> TGGCCGCGAGG
TGGCCGCGAGG -> GGCCGCGAGGT
GGCCGCGAGGT -> GCCGCGAGGTA
GCCGCGAGGTA -> CCGCGAGGTAT
CCGCGAGGTAT -> CGCGAGGTATG
CGCGAGGTATG -> GCGAGGTATGC
GCGAGGTATGC -> CGAGGTATGCC
CGAGGTATGCC -> GAGGTATGCCC
GAGGTATGCCC -> AGGTATGCCCC
AGGTATGCCCC -> GGTATGCCCCC
GGTATGCCCCC -> GTATGCCCCCT
GTATGCCCCCT -> TATGCCCCCTT
TATGCCCCCTT -> ATGCCCCCTTG
ATGCCCCCTTG -> TGCCCCCTTGC
TGCCCCCTTGC -> GCCCCCTTGCT
GCCCCCTTGCT -> CCCCCTTGCTC
CCCCCTTGCTC -> CCCCTTGCTCC
CCCCTTGCTCC -> CCCTTGCTCCG
CCCTTGCTCCG -> CCTTGCTCCGG
CCTTGCTCCGG -> CTTGCTCCGGT
CTTGCTCCGGT -> TTGCTCCGGTT
TTGCTCCGGTT -> TGCTCCGGTTG
TGCTCCGGTTG -> GCTCCGGTTGC
GCTCCGGTTGC -> CTCCGGTTGCT
CTCCGGTTGCT -> TCCGGTTGCTA
TCCGGTTGCTA -> CCGGTTGCTAT
CCGGTTGCTAT -> CGGTTGCTATA
CGGTTGCTATA -> GGTTGCTATAT
GGTTGCTATAT -> GTTGCTATATG
GTTGCTATATG -> TTGCTATATGC
TTGCTATATGC -> TGCTATATGCC
TGCTATATGCC -> GCTATATGCCA
GCTATATGCCA -> CTATATGCCAT
CTATATGCCAT -> TATATGCCATC
TATATGCCATC -> ATATGCCATCT
ATATGCCATCT -> TATGCCATCTT
TATGCCATCTT -> ATGCCATCTTC
ATGCCATCTTC -> TGCCATCTTCA
TGCCATCTTCA -> GCCATCTTCAT
GCCATCTTCAT -> CCATCTTCATA
CCATCTTCATA -> CATCTTCATAG
CATCTTCATAG -> ATCTTCATAGA
ATCTTCATAGA -> TCTTCATAGAC
TCTTCATAGAC -> CTTCATAGACA
CTTCATAGACA -> TTCATAGACAC
TTCATAGACAC -> TCATAGACACG
TCATAGACACG -> CATAGACACGG
CATAGACACGG -> ATAGACACGGC
ATAGACACGGC -> TAGACACGGCC
TAGACACGGCC -> AGACACGGCCC
AGACACGGCCC -> GACACGGCCCC
GACACGGCCCC -> ACACGGCCCCT
ACACGGCCCCT -> CACGGCCCCTT
CACGGCCCCTT -> ACGGCCCCTTA
ACGGCCCCTTA -> CGGCCCCTTAT
CGGCCCCTTAT -> GGCCCCTTATA
GGCCCCTTATA -> GCCCCTTATAG
GCCCCTTATAG -> CCCCTTATAGA
CCCCTTATAGA -> CCCTTATAGAT
CCCTTATAGAT -> CCTTATAGATA
CCTTATAGATA -> CTTATAGATAC
CTTATAGATAC -> TTATAGATACA
TTATAGATACA -> TATAGATACAC
TATAGATACAC -> ATAGATACACC
ATAGATACACC -> TAGATACACCT
TAGATACACCT -> AGATACACCTA
AGATACACCTA -> GATACACCTAT
GATACACCTAT -> ATACACCTATT
ATACACCTATT -> TACACCTATTT
TACACCTATTT -> ACACCTATTTT
ACACCTATTTT -> CACCTATTTTG
CACCTATTTTG -> ACCTATTTTGT
ACCTATTTTGT -> CCTATTTTGTG
CCTATTTTGTG -> CTATTTTGTGT
CTATTTTGTGT -> TATTTTGTGTG
TATTTTGTGTG -> ATTTTGTGTGC
ATTTTGTGTGC -> TTTTGTGTGCT
TTTTGTGTGCT -> TTTGTGTGCTT
TTTGTGTGCTT -> TTGTGTGCTTA
TTGTGTGCTTA -> TGTGTGCTTAA
TGTGTGCTTAA -> GTGTGCTTAAC
GTGTGCTTAAC -> TGTGCTTAACA
TGTGCTTAACA -> GTGCTTAACAT
GTGCTTAACAT -> TGCTTAACATA
TGCTTAACATA -> GCTTAACATAG
GCTTAACATAG -> CTTAACATAGC
CTTAACATAGC -> TTAACATAGCG
TTAACATAGCG -> TAACATAGCGG
TAACATAGCGG -> AACATAGCGGG
AACATAGCGGG -> ACATAGCGGGC
ACATAGCGGGC -> CATAGCGGGCA
CATAGCGGGCA -> ATAGCGGGCAA
ATAGCGGGCAA -> TAGCGGGCAAA
TAGCGGGCAAA -> AGCGGGCAAAG
AGCGGGCAAAG -> GCGGGCAAAGC
GCGGGCAAAGC -> CGGGCAAAGCT
CGGGCAAAGCT -> GGGCAAAGCTA
GGGCAAAGCTA -> GGCAAAGCTAA
GGCAAAGCTAA -> GCAAAGCTAAA
GCAAAGCTAAA -> CAAAGCTAAAA
CAAAGCTAAAA -> AAAGCTAAAAG
AAAGCTAAAAG -> AAGCTAAAAGC
AAGCTAAAAGC -> AGCTAAAAGCC
AGCTAAAAGCC -> GCTAAAAGCCT
GCTAAAAGCCT -> CTAAAAGCCTC
CTAAAAGCCTC -> TAAAAGCCTCG
TAAAAGCCTCG -> AAAAGCCTCGG
AAAAGCCTCGG -> AAAGCCTCGGC
AAAGCCTCGGC -> AAGCCTCGGCG
AAGCCTCGGCG -> AGCCTCGGCGC
AGCCTCGGCGC -> GCCTCGGCGCA
GCCTCGGCGCA -> CCTCGGCGCAT
CCTCGGCGCAT -> CTCGGCGCATT
CTCGGCGCATT -> TCGGCGCATTG
TCGGCGCATTG -> CGGCGCATTGT
CGGCGCATTGT -> GGCGCATTGTC
GGCGCATTGTC -> GCGCATTGTCG
GCGCATTGTCG -> CGCATTGTCGG
CGCATTGTCGG -> GCATTGTCGGC
GCATTGTCGGC -> CATTGTCGGCC
CATTGTCGGCC -> ATTGTCGGCCG
ATTGTCGGCCG -> TTGTCGGCCGT
TTGTCGGCCGT -> TGTCGGCCGTC
TGTCGGCCGTC -> GTCGGCCGTCC
GTCGGCCGTCC -> TCGGCCGTCCC
TCGGCCGTCCC -> CGGCCGTCCCT
CGGCCGTCCCT -> GGCCGTCCCTA
GGCCGTCCCTA -> GCCGTCCCTAT
GCCGTCCCTAT -> CCGTCCCTATT
CCGTCCCTATT -> CGTCCCTATTC
CGTCCCTATTC -> GTCCCTATTCA
GTCCCTATTCA -> TCCCTATTCAT
TCCCTATTCAT -> CCCTATTCATC
CCCTATTCATC -> CCTATTCATCC
CCTATTCATCC -> CTATTCATCCC
CTATTCATCCC -> TATTCATCCCC
TATTCATCCCC -> ATTCATCCCCA
ATTCATCCCCA -> TTCATCCCCAA
TTCATCCCCAA -> TCATCCCCAAT
TCATCCCCAAT -> CATCCCCAATC
CATCCCCAATC -> ATCCCCAATCG
ATCCCCAATCG -> TCCCCAATCGT
TCCCCAATCGT -> CCCCAATCGTT
CCCCAATCGTT -> CCCAATCGTTT
CCCAATCGTTT -> CCAATCGTTTC
CCAATCGTTTC -> CAATCGTTTCG
CAATCGTTTCG -> AATCGTTTCGA
AATCGTTTCGA -> ATCGTTTCGAT
ATCGTTTCGAT -> TCGTTTCGATA
TCGTTTCGATA -> CGTTTCGATAA
CGTTTCGATAA -> GTTTCGATAAC
GTTTCGATAAC -> TTTCGATAACG
TTTCGATAACG -> TTCGATAACGT
TTCGATAACGT -> TCGATAACGTC
TCGATAACGTC -> CGATAACGTCC
CGATAACGTCC -> GATAACGTCCA
GATAACGTCCA -> ATAACGTCCAG
ATAACGTCCAG -> TAACGTCCAGT
TAACGTCCAGT -> AACGTCCAGTT
AACGTCCAGTT -> ACGTCCAGTTG
ACGTCCAGTTG -> CGTCCAGTTGT
CGTCCAGTTGT -> GTCCAGTTGTA
GTCCAGTTGTA -> TCCAGTTGTAC
TCCAGTTGTAC -> CCAGTTGTACG
CCAGTTGTACG -> CAGTTGTACGG
CAGTTGTACGG -> AGTTGTACGGG
AGTTGTACGGG -> GTTGTACGGGC
GTTGTACGGGC -> TTGTACGGGCA
TTGTACGGGCA -> TGTACGGGCAT
TGTACGGGCAT -> GTACGGGCATC
GTACGGGCATC -> TACGGGCATCA
TACGGGCATCA -> ACGGGCATCAT
ACGGGCATCAT -> CGGGCATCATG
CGGGCATCATG -> GGGCATCATGA
GGGCATCATGA -> GGCATCATGAT
GGCATCATGAT -> GCATCATGATG
GCATCATGATG -> CATCATGATGC
CATCATGATGC -> ATCATGATGCT
ATCATGATGCT -> TCATGATGCTT
TCATGATGCTT -> CATGATGCTTC
CATGATGCTTC -> ATGATGCTTCG
ATGATGCTTCG -> TGATGCTTCGG
TGATGCTTCGG -> GATGCTTCGGC
GATGCTTCGGC -> ATGCTTCGGCC
ATGCTTCGGCC -> TGCTTCGGCCT
TGCTTCGGCCT -> GCTTCGGCCTA
GCTTCGGCCTA -> CTTCGGCCTAA
CTTCGGCCTAA -> TTCGGCCTAAC
TTCGGCCTAAC -> TCGGCCTAACA
TCGGCCTAACA -> CGGCCTAACAT
CGGCCTAACAT -> GGCCTAACATC
GGCCTAACATC -> GCCTAACATCT
GCCTAACATCT -> CCTAACATCTG
CCTAACATCTG -> CTAACATCTGT
CTAACATCTGT -> TAACATCTGTA
TAACATCTGTA -> AACATCTGTAA
AACATCTGTAA -> ACATCTGTAAT
ACATCTGTAAT -> CATCTGTAATA
CATCTGTAATA -> ATCTGTAATAG
ATCTGTAATAG -> TCTGTAATAGA
TCTGTAATAGA -> CTGTAATAGAG
CTGTAATAGAG -> TGTAATAGAGG
TGTAATAGAGG -> GTAATAGAGGA
GTAATAGAGGA -> TAATAGAGGAC
TAATAGAGGAC -> AATAGAGGACT
AATAGAGGACT -> ATAGAGGACTA
ATAGAGGACTA -> TAGAGGACTAC
TAGAGGACTAC -> AGAGGACTACT
AGAGGACTACT -> GAGGACTACTA
GAGGACTACTA -> AGGACTACTAA
AGGACTACTAA -> GGACTACTAAT
GGACTACTAAT -> GACTACTAATG
GACTACTAATG -> ACTACTAATGT
ACTACTAATGT -> CTACTAATGTG
CTACTAATGTG -> TACTAATGTGT
TACTAATGTGT -> ACTAATGTGTT
ACTAATGTGTT -> CTAATGTGTTG
CTAATGTGTTG -> TAATGTGTTGA
TAATGTGTTGA -> AATGTGTTGAA
AATGTGTTGAA -> ATGTGTTGAAG
ATGTGTTGAAG -> TGTGTTGAAGA
TGTGTTGAAGA -> GTGTTGAAGAT
GTGTTGAAGAT -> TGTTGAAGATT
TGTTGAAGATT -> GTTGAAGATTT
GTTGAAGATTT -> TTGAAGATTTA
TTGAAGATTTA -> TGAAGATTTAT
TGAAGATTTAT -> GAAGATTTATG
GAAGATTTATG -> AAGATTTATGG
AAGATTTATGG -> AGATTTATGGC
AGATTTATGGC -> GATTTATGGCT
GATTTATGGCT -> ATTTATGGCTA
ATTTATGGCTA -> TTTATGGCTAG
TTTATGGCTAG -> TTATGGCTAGA
TTATGGCTAGA -> TATGGCTAGAT
TATGGCTAGAT -> ATGGCTAGATT
ATGGCTAGATT -> TGGCTAGATTT
TGGCTAGATTT -> GGCTAGATTTG
GGCTAGATTTG -> GCTAGATTTGC
GCTAGATTTGC -> CTAGATTTGCT
CTAGATTTGCT -> TAGATTTGCTA
TAGATTTGCTA -> AGATTTGCTAT
AGATTTGCTAT -> GATTTGCTATG
GATTTGCTATG -> ATTTGCTATGA
ATTTGCTATGA -> TTTGCTATGAG
TTTGCTATGAG -> TTGCTATGAGT
TTGCTATGAGT -> TGCTATGAGTT
TGCTATGAGTT -> GCTATGAGTTA
GCTATGAGTTA -> CTATGAGTTAG
CTATGAGTTAG -> TATGAGTTAGA
TATGAGTTAGA -> ATGAGTTAGAG
ATGAGTTAGAG -> TGAGTTAGAGC
TGAGTTAGAGC -> GAGTTAGAGCC
GAGTTAGAGCC -> AGTTAGAGCCA
AGTTAGAGCCA -> GTTAGAGCCAA
GTTAGAGCCAA -> TTAGAGCCAAA
TTAGAGCCAAA -> TAGAGCCAAAA
TAGAGCCAAAA -> AGAGCCAAAAG
AGAGCCAAAAG -> GAGCCAAAAGT
GAGCCAAAAGT -> AGCCAAAAGTA
AGCCAAAAGTA -> GCCAAAAGTAT
GCCAAAAGTAT -> CCAAAAGTATT
CCAAAAGTATT -> CAAAAGTATTT
CAAAAGTATTT -> AAAAGTATTTG
AAAAGTATTTG -> AAAGTATTTGA
AAAGTATTTGA -> AAGTATTTGAT
AAGTATTTGAT -> AGTATTTGATA
AGTATTTGATA -> GTATTTGATAG
GTATTTGATAG -> TATTTGATAGT
TATTTGATAGT -> ATTTGATAGTC
ATTTGATAGTC -> TTTGATAGTCT
TTTGATAGTCT -> TTGATAGTCTT
TTGATAGTCTT -> TGATAGTCTTC
TGATAGTCTTC -> GATAGTCTTCC
GATAGTCTTCC -> ATAGTCTTCCC
ATAGTCTTCCC -> TAGTCTTCCCC
TAGTCTTCCCC -> AGTCTTCCCCT
AGTCTTCCCCT -> GTCTTCCCCTT
GTCTTCCCCTT -> TCTTCCCCTTA
TCTTCCCCTTA -> CTTCCCCTTAC
CTTCCCCTTAC -> TTCCCCTTACG
TTCCCCTTACG -> TCCCCTTACGG
TCCCCTTACGG -> CCCCTTACGGG
CCCCTTACGGG -> CCCTTACGGGT
CCCTTACGGGT -> CCTTACGGGTC
CCTTACGGGTC -> CTTACGGGTCG
CTTACGGGTCG -> TTACGGGTCGC
TTACGGGTCGC -> TACGGGTCGCA
TACGGGTCGCA -> ACGGGTCGCAA
ACGGGTCGCAA -> CGGGTCGCAAG
CGGGTCGCAAG -> GGGTCGCAAGC
GGGTCGCAAGC -> GGTCGCAAGCG
GGTCGCAAGCG -> GTCGCAAGCGT
GTCGCAAGCGT -> TCGCAAGCGTA
TCGCAAGCGTA -> CGCAAGCGTAC
CGCAAGCGTAC -> GCAAGCGTACT
GCAAGCGTACT -> CAAGCGTACTT
CAAGCGTACTT -> AAGCGTACTTG
AAGCGTACTTG -> AGCGTACTTGT
AGCGTACTTGT -> GCGTACTTGTT
GCGTACTTGTT -> CGTACTTGTTA
CGTACTTGTTA -> GTACTTGTTAA
GTACTTGTTAA -> TACTTGTTAAC
TACTTGTTAAC -> ACTTGTTAACC
ACTTGTTAACC -> CTTGTTAACCA
CTTGTTAACCA -> TTGTTAACCAA
TTGTTAACCAA -> TGTTAACCAAG
TGTTAACCAAG -> GTTAACCAAGC
GTTAACCAAGC -> TTAACCAAGCC
TTAACCAAGCC -> TAACCAAGCCT
TAACCAAGCCT -> AACCAAGCCTT
AACCAAGCCTT -> ACCAAGCCTTC
ACCAAGCCTTC -> CCAAGCCTTCT
CCAAGCCTTCT -> CAAGCCTTCTC
CAAGCCTTCTC -> AAGCCTTCTCA
AAGCCTTCTCA -> AGCCTTCTCAA
AGCCTTCTCAA -> GCCTTCTCAAA
GCCTTCTCAAA -> CCTTCTCAAAT
CCTTCTCAAAT -> CTTCTCAAATC
CTTCTCAAATC -> TTCTCAAATCC
TTCTCAAATCC -> TCTCAAATCCC
TCTCAAATCCC -> CTCAAATCCCG
CTCAAATCCCG -> TCAAATCCCGC
TCAAATCCCGC -> CAAATCCCGCT
CAAATCCCGCT -> AAATCCCGCTT
AAATCCCGCTT -> AATCCCGCTTC
AATCCCGCTTC -> ATCCCGCTTCC
ATCCCGCTTCC -> TCCCGCTTCCG
TCCCGCTTCCG -> CCCGCTTCCGT
CCCGCTTCCGT -> CCGCTTCCGTC
CCGCTTCCGTC -> CGCTTCCGTCG
CGCTTCCGTCG -> GCTTCCGTCGG
GCTTCCGTCGG -> CTTCCGTCGGT
CTTCCGTCGGT -> TTCCGTCGGTA
TTCCGTCGGTA -> TCCGTCGGTAG
TCCGTCGGTAG -> CCGTCGGTAGT
CCGTCGGTAGT -> CGTCGGTAGTG
CGTCGGTAGTG -> GTCGGTAGTGG
GTCGGTAGTGG -> TCGGTAGTGGT
TCGGTAGTGGT -> CGGTAGTGGTA
CGGTAGTGGTA -> GGTAGTGGTAG
GGTAGTGGTAG -> GTAGTGGTAGC
GTAGTGGTAGC -> TAGTGGTAGCG
TAGTGGTAGCG -> AGTGGTAGCGC
AGTGGTAGCGC -> GTGGTAGCGCC
GTGGTAGCGCC -> TGGTAGCGCCC
TGGTAGCGCCC -> GGTAGCGCCCT
GGTAGCGCCCT -> GTAGCGCCCTA
GTAGCGCCCTA -> TAGCGCCCTAT
TAGCGCCCTAT -> AGCGCCCTATC
AGCGCCCTATC -> GCGCCCTATCT
GCGCCCTATCT -> CGCCCTATCTT
CGCCCTATCTT -> GCCCTATCTTT
GCCCTATCTTT -> CCCTATCTTTC
CCCTATCTTTC -> CCTATCTTTCA
CCTATCTTTCA -> CTATCTTTCAG
CTATCTTTCAG -> TATCTTTCAGG
TATCTTTCAGG -> ATCTTTCAGGC
ATCTTTCAGGC -> TCTTTCAGGCT
TCTTTCAGGCT -> CTTTCAGGCTC
CTTTCAGGCTC -> TTTCAGGCTCA
TTTCAGGCTCA -> TTCAGGCTCAC
TTCAGGCTCAC -> TCAGGCTCACT
TCAGGCTCACT -> CAGGCTCACTT
CAGGCTCACTT -> AGGCTCACTTA
AGGCTCACTTA -> GGCTCACTTAA
GGCTCACTTAA -> GCTCACTTAAG
GCTCACTTAAG -> CTCACTTAAGC
CTCACTTAAGC -> TCACTTAAGCG
TCACTTAAGCG -> CACTTAAGCGC
CACTTAAGCGC -> ACTTAAGCGCT
ACTTAAGCGCT -> CTTAAGCGCTT
CTTAAGCGCTT -> TTAAGCGCTTA
TTAAGCGCTTA -> TAAGCGCTTAG
TAAGCGCTTAG -> AAGCGCTTAGG
AAGCGCTTAGG -> AGCGCTTAGGG
AGCGCTTAGGG -> GCGCTTAGGGT
GCGCTTAGGGT -> CGCTTAGGGTC
CGCTTAGGGTC -> GCTTAGGGTCA
GCTTAGGGTCA -> CTTAGGGTCAG
CTTAGGGTCAG -> TTAGGGTCAGT
TTAGGGTCAGT -> TAGGGTCAGTG
TAGGGTCAGTG -> AGGGTCAGTGT
AGGGTCAGTGT -> GGGTCAGTGTT
GGGTCAGTGTT -> GGTCAGTGTTG
GGTCAGTGTTG -> GTCAGTGTTGA
GTCAGTGTTGA -> TCAGTGTTGAC
TCAGTGTTGAC -> CAGTGTTGACC
CAGTGTTGACC -> AGTGTTGACCC
AGTGTTGACCC -> GTGTTGACCCG
GTGTTGACCCG -> TGTTGACCCGT
TGTTGACCCGT -> GTTGACCCGTT
GTTGACCCGTT -> TTGACCCGTTC
TTGACCCGTTC -> TGACCCGTTCG
TGACCCGTTCG -> GACCCGTTCGT
GACCCGTTCGT -> ACCCGTTCGTG
ACCCGTTCGTG -> CCCGTTCGTGC
CCCGTTCGTGC -> CCGTTCGTGCT
CCGTTCGTGCT -> CGTTCGTGCTT
CGTTCGTGCTT -> GTTCGTGCTTA
GTTCGTGCTTA -> TTCGTGCTTAC
TTCGTGCTTAC -> TCGTGCTTACG
TCGTGCTTACG -> CGTGCTTACGC
CGTGCTTACGC -> GTGCTTACGCA
GTGCTTACGCA -> TGCTTACGCAA
TGCTTACGCAA -> GCTTACGCAAG
GCTTACGCAAG -> CTTACGCAAGA
CTTACGCAAGA -> TTACGCAAGAA
TTACGCAAGAA -> TACGCAAGAAA
TACGCAAGAAA -> ACGCAAGAAAC
ACGCAAGAAAC -> CGCAAGAAACA
CGCAAGAAACA -> GCAAGAAACAG
GCAAGAAACAG -> CAAGAAACAGA
CAAGAAACAGA -> AAGAAACAGAT
AAGAAACAGAT -> AGAAACAGATC
AGAAACAGATC -> GAAACAGATCT
GAAACAGATCT -> AAACAGATCTT
AAACAGATCTT -> AACAGATCTTG
AACAGATCTTG -> ACAGATCTTGT
ACAGATCTTGT -> CAGATCTTGTA
CAGATCTTGTA -> AGATCTTGTAG
AGATCTTGTAG -> GATCTTGTAGT
GATCTTGTAGT -> ATCTTGTAGTG
ATCTTGTAGTG -> TCTTGTAGTGT
TCTTGTAGTGT -> CTTGTAGTGTA
CTTGTAGTGTA -> TTGTAGTGTAG
TTGTAGTGTAG -> TGTAGTGTAGG
TGTAGTGTAGG -> GTAGTGTAGGA
GTAGTGTAGGA -> TAGTGTAGGAG
TAGTGTAGGAG -> AGTGTAGGAGA
AGTGTAGGAGA -> GTGTAGGAGAC
GTGTAGGAGAC -> TGTAGGAGACG
TGTAGGAGACG -> GTAGGAGACGG
GTAGGAGACGG -> TAGGAGACGGG
TAGGAGACGGG -> AGGAGACGGGT
AGGAGACGGGT -> GGAGACGGGTG
GGAGACGGGTG -> GAGACGGGTGG
GAGACGGGTGG -> AGACGGGTGGT
AGACGGGTGGT -> GACGGGTGGTG
GACGGGTGGTG -> ACGGGTGGTGA
ACGGGTGGTGA -> CGGGTGGTGAG
CGGGTGGTGAG -> GGGTGGTGAGC
GGGTGGTGAGC -> GGTGGTGAGCT
GGTGGTGAGCT -> GTGGTGAGCTG
GTGGTGAGCTG -> TGGTGAGCTGC
TGGTGAGCTGC -> GGTGAGCTGCG
GGTGAGCTGCG -> GTGAGCTGCGG
GTGAGCTGCGG -> TGAGCTGCGGC
TGAGCTGCGGC -> GAGCTGCGGCG
GAGCTGCGGCG -> AGCTGCGGCGA
AGCTGCGGCGA -> GCTGCGGCGAA
GCTGCGGCGAA -> CTGCGGCGAAT
CTGCGGCGAAT -> TGCGGCGAATT
TGCGGCGAATT -> GCGGCGAATTC
GCGGCGAATTC -> CGGCGAATTCC
CGGCGAATTCC -> GGCGAATTCCT
GGCGAATTCCT -> GCGAATTCCTG
GCGAATTCCTG -> CGAATTCCTGT
CGAATTCCTGT -> GAATTCCTGTC
GAATTCCTGTC -> AATTCCTGTCC
AATTCCTGTCC -> ATTCCTGTCCC
ATTCCTGTCCC -> TTCCTGTCCCG
TTCCTGTCCCG -> TCCTGTCCCGC
TCCTGTCCCGC -> CCTGTCCCGCG
CCTGTCCCGCG -> CTGTCCCGCGG
CTGTCCCGCGG -> TGTCCCGCGGG
TGTCCCGCGGG -> GTCCCGCGGGC,GTCCCGCGGGC
GTCCCGCGGGC -> TCCCGCGGGCC,TCCCGCGGGCA
TCCCGCGGGCC -> CCCGCGGGCCT
CCCGCGGGCCT -> CCGCGGGCCTA
CCGCGGGCCTA -> CGCGGGCCTAT
CGCGGGCCTAT -> GCGGGCCTATA
GCGGGCCTATA -> CGGGCCTATAC
CGGGCCTATAC -> GGGCCTATACA
GGGCCTATACA -> GGCCTATACAT
GGCCTATACAT -> GCCTATACATT
GCCTATACATT -> CCTATACATTA
CCTATACATTA -> CTATACATTAT
CTATACATTAT -> TATACATTATC
TATACATTATC -> ATACATTATCG
ATACATTATCG -> TACATTATCGC
TACATTATCGC -> ACATTATCGCT
ACATTATCGCT -> CATTATCGCTC
CATTATCGCTC -> ATTATCGCTCC
ATTATCGCTCC -> TTATCGCTCCA
TTATCGCTCCA -> TATCGCTCCAT
TATCGCTCCAT -> ATCGCTCCATA
ATCGCTCCATA -> TCGCTCCATAC
TCGCTCCATAC -> CGCTCCATACA
CGCTCCATACA -> GCTCCATACAA
GCTCCATACAA -> CTCCATACAAA
CTCCATACAAA -> TCCATACAAAC
TCCATACAAAC -> CCATACAAACA
CCATACAAACA -> CATACAAACAG
CATACAAACAG -> ATACAAACAGT
ATACAAACAGT -> TACAAACAGTT
TACAAACAGTT -> ACAAACAGTTA
ACAAACAGTTA -> CAAACAGTTAA
CAAACAGTTAA -> AAACAGTTAAG
AAACAGTTAAG -> AACAGTTAAGA
AACAGTTAAGA -> ACAGTTAAGAG
ACAGTTAAGAG -> CAGTTAAGAGC
CAGTTAAGAGC -> AGTTAAGAGCC
AGTTAAGAGCC -> GTTAAGAGCCC
GTTAAGAGCCC -> TTAAGAGCCCG
TTAAGAGCCCG -> TAAGAGCCCGA
TAAGAGCCCGA -> AAGAGCCCGAT
AAGAGCCCGAT -> AGAGCCCGATA
AGAGCCCGATA -> GAGCCCGATAA
GAGCCCGATAA -> AGCCCGATAAG
AGCCCGATAAG -> GCCCGATAAGA
GCCCGATAAGA -> CCCGATAAGAA
CCCGATAAGAA -> CCGATAAGAAA
CCGATAAGAAA -> CGATAAGAAAG
CGATAAGAAAG -> GATAAGAAAGC
GATAAGAAAGC -> ATAAGAAAGCC
ATAAGAAAGCC -> TAAGAAAGCCC
TAAGAAAGCCC -> AAGAAAGCCCG
AAGAAAGCCCG -> AGAAAGCCCGG
AGAAAGCCCGG -> GAAAGCCCGGG
GAAAGCCCGGG -> AAAGCCCGGGT
AAAGCCCGGGT -> AAGCCCGGGTG
AAGCCCGGGTG -> AGCCCGGGTGG
AGCCCGGGTGG -> GCCCGGGTGGG
GCCCGGGTGGG -> CCCGGGTGGGT
CCCGGGTGGGT -> CCGGGTGGGTC
CCGGGTGGGTC -> CGGGTGGGTCG
CGGGTGGGTCG -> GGGTGGGTCGT
GGGTGGGTCGT -> GGTGGGTCGTG
GGTGGGTCGTG -> GTGGGTCGTGA
GTGGGTCGTGA -> TGGGTCGTGAA
TGGGTCGTGAA -> GGGTCGTGAAA
GGGTCGTGAAA -> GGTCGTGAAAT
GGTCGTGAAAT -> GTCGTGAAATG
GTCGTGAAATG -> TCGTGAAATGG
TCGTGAAATGG -> CGTGAAATGGC
CGTGAAATGGC -> GTGAAATGGCG
GTGAAATGGCG -> TGAAATGGCGG
TGAAATGGCGG -> GAAATGGCGGT
GAAATGGCGGT -> AAATGGCGGTT
AAATGGCGGTT -> AATGGCGGTTC
AATGGCGGTTC -> ATGGCGGTTCT
ATGGCGGTTCT -> TGGCGGTTCTC
TGGCGGTTCTC -> GGCGGTTCTCG
GGCGGTTCTCG -> GCGGTTCTCGG
GCGGTTCTCGG -> CGGTTCTCGGT
CGGTTCTCGGT -> GGTTCTCGGTC
GGTTCTCGGTC -> GTTCTCGGTCT
GTTCTCGGTCT -> TTCTCGGTCTG
TTCTCGGTCTG -> TCTCGGTCTGT
TCTCGGTCTGT -> CTCGGTCTGTT
CTCGGTCTGTT -> TCGGTCTGTTG
TCGGTCTGTTG -> CGGTCTGTTGA
CGGTCTGTTGA -> GGTCTGTTGAT
GGTCTGTTGAT -> GTCTGTTGATG
GTCTGTTGATG -> TCTGTTGATGA
TCTGTTGATGA -> CTGTTGATGAC
CTGTTGATGAC -> TGTTGATGACA
TGTTGATGACA -> GTTGATGACAT
GTTGATGACAT -> TTGATGACATT
TTGATGACATT -> TGATGACATTT
TGATGACATTT -> GATGACATTTC
GATGACATTTC -> ATGACATTTCT
ATGACATTTCT -> TGACATTTCTG
TGACATTTCTG -> GACATTTCTGT
GACATTTCTGT -> ACATTTCTGTA
ACATTTCTGTA -> CATTTCTGTAT
CATTTCTGTAT -> ATTTCTGTATG
ATTTCTGTATG -> TTTCTGTATGC
TTTCTGTATGC -> TTCTGTATGCA
TTCTGTATGCA -> TCTGTATGCAC
TCTGTATGCAC -> CTGTATGCACC
CTGTATGCACC -> TGTATGCACCT
TGTATGCACCT -> GTATGCACCTG
GTATGCACCTG -> TATGCACCTGG
TATGCACCTGG -> ATGCACCTGGT
ATGCACCTGGT -> TGCACCTGGTA
TGCACCTGGTA -> GCACCTGGTAG
GCACCTGGTAG -> CACCTGGTAGG
CACCTGGTAGG -> ACCTGGTAGGC
ACCTGGTAGGC -> CCTGGTAGGCG
CCTGGTAGGCG -> CTGGTAGGCGC
CTGGTAGGCGC -> TGGTAGGCGCA
TGGTAGGCGCA -> GGTAGGCGCAG
GGTAGGCGCAG -> GTAGGCGCAGA
GTAGGCGCAGA -> TAGGCGCAGAC
TAGGCGCAGAC -> AGGCGCAGACT
AGGCGCAGACT -> GGCGCAGACTA
GGCGCAGACTA -> GCGCAGACTAC
GCGCAGACTAC -> CGCAGACTACT
CGCAGACTACT -> GCAGACTACTG
GCAGACTACTG -> CAGACTACTGC
CAGACTACTGC -> AGACTACTGCT
AGACTACTGCT -> GACTACTGCTC
GACTACTGCTC -> ACTACTGCTCA
ACTACTGCTCA -> CTACTGCTCAC
CTACTGCTCAC -> TACTGCTCACC
TACTGCTCACC -> ACTGCTCACCA
ACTGCTCACCA -> CTGCTCACCAC
CTGCTCACCAC -> TGCTCACCACC
TGCTCACCACC -> GCTCACCACCG
GCTCACCACCG -> CTCACCACCGG
CTCACCACCGG -> TCACCACCGGC
TCACCACCGGC -> CACCACCGGCG
CACCACCGGCG -> ACCACCGGCGG
ACCACCGGCGG -> CCACCGGCGGT
CCACCGGCGGT -> CACCGGCGGTG
CACCGGCGGTG -> ACCGGCGGTGC
ACCGGCGGTGC -> CCGGCGGTGCC
CCGGCGGTGCC -> CGGCGGTGCCC
CGGCGGTGCCC -> GGCGGTGCCCA
GGCGGTGCCCA -> GCGGTGCCCAG
GCGGTGCCCAG -> CGGTGCCCAGA
CGGTGCCCAGA -> GGTGCCCAGAG
GGTGCCCAGAG -> GTGCCCAGAGA
GTGCCCAGAGA -> TGCCCAGAGAC
TGCCCAGAGAC -> GCCCAGAGACC
GCCCAGAGACC -> CCCAGAGACCT
CCCAGAGACCT -> CCAGAGACCTA
CCAGAGACCTA -> CAGAGACCTAG
CAGAGACCTAG -> AGAGACCTAGA
AGAGACCTAGA -> GAGACCTAGAA
GAGACCTAGAA -> AGACCTAGAAC
AGACCTAGAAC -> GACCTAGAACG
GACCTAGAACG -> ACCTAGAACGT
ACCTAGAACGT -> CCTAGAACGTT
CCTAGAACGTT -> CTAGAACGTTT
CTAGAACGTTT -> TAGAACGTTTA
TAGAACGTTTA -> AGAACGTTTAC
AGAACGTTTAC -> GAACGTTTACT
GAACGTTTACT -> AACGTTTACTC
AACGTTTACTC -> ACGTTTACTCG
ACGTTTACTCG -> CGTTTACTCGC
CGTTTACTCGC -> GTTTACTCGCC
GTTTACTCGCC -> TTTACTCGCCA
TTTACTCGCCA -> TTACTCGCCAC
TTACTCGCCAC -> TACTCGCCACG
TACTCGCCACG -> ACTCGCCACGT
ACTCGCCACGT -> CTCGCCACGTT
CTCGCCACGTT -> TCGCCACGTTG
TCGCCACGTTG -> CGCCACGTTGA
CGCCACGTTGA -> GCCACGTTGAT
GCCACGTTGAT -> CCACGTTGATA
CCACGTTGATA -> CACGTTGATAT
CACGTTGATAT -> ACGTTGATATT
ACGTTGATATT -> CGTTGATATTC
CGTTGATATTC -> GTTGATATTCA
GTTGATATTCA -> TTGATATTCAA
TTGATATTCAA -> TGATATTCAAA
TGATATTCAAA -> GATATTCAAAT
GATATTCAAAT -> ATATTCAAATG
ATATTCAAATG -> TATTCAAATGT
TATTCAAATGT -> ATTCAAATGTT
ATTCAAATGTT -> TTCAAATGTTC
TTCAAATGTTC -> TCAAATGTTCC
TCAAATGTTCC -> CAAATGTTCCC
CAAATGTTCCC -> AAATGTTCCCC
AAATGTTCCCC -> AATGTTCCCCC
AATGTTCCCCC -> ATGTTCCCCCG
ATGTTCCCCCG -> TGTTCCCCCGA
TGTTCCCCCGA -> GTTCCCCCGAC
GTTCCCCCGAC -> TTCCCCCGACC
TTCCCCCGACC -> TCCCCCGACCA
TCCCCCGACCA -> CCCCCGACCAG
CCCCCGACCAG -> CCCCGACCAGC
CCCCGACCAGC -> CCCGACCAGCA
CCCGACCAGCA -> CCGACCAGCAA
CCGACCAGCAA -> CGACCAGCAAG
CGACCAGCAAG -> GACCAGCAAGC
GACCAGCAAGC -> ACCAGCAAGCC
ACCAGCAAGCC -> CCAGCAAGCCC
CCAGCAAGCCC -> CAGCAAGCCCT
CAGCAAGCCCT -> AGCAAGCCCTT
AGCAAGCCCTT -> GCAAGCCCTTG
GCAAGCCCTTG -> CAAGCCCTTGG
CAAGCCCTTGG -> AAGCCCTTGGG
AAGCCCTTGGG -> AGCCCTTGGGA
AGCCCTTGGGA -> GCCCTTGGGAT
GCCCTTGGGAT -> CCCTTGGGATC
CCCTTGGGATC -> CCTTGGGATCC
CCTTGGGATCC -> CTTGGGATCCG
CTTGGGATCCG -> TTGGGATCCGA
TTGGGATCCGA -> TGGGATCCGAT
TGGGATCCGAT -> GGGATCCGATG
GGGATCCGATG -> GGATCCGATGA
GGATCCGATGA -> GATCCGATGAG
GATCCGATGAG -> ATCCGATGAGC
ATCCGATGAGC -> TCCGATGAGCA
TCCGATGAGCA -> CCGATGAGCAT
CCGATGAGCAT -> CGATGAGCATG
CGATGAGCATG -> GATGAGCATGA
GATGAGCATGA -> ATGAGCATGAA
ATGAGCATGAA -> TGAGCATGAAA
TGAGCATGAAA -> GAGCATGAAAG
GAGCATGAAAG -> AGCATGAAAGT
AGCATGAAAGT -> GCATGAAAGTA
GCATGAAAGTA -> CATGAAAGTAT
CATGAAAGTAT -> ATGAAAGTATA
ATGAAAGTATA -> TGAAAGTATAG
TGAAAGTATAG -> GAAAGTATAGA
GAAAGTATAGA -> AAAGTATAGAG
AAAGTATAGAG -> AAGTATAGAGG
AAGTATAGAGG -> AGTATAGAGGT
AGTATAGAGGT -> GTATAGAGGTC
GTATAGAGGTC -> TATAGAGGTCC
TATAGAGGTCC -> ATAGAGGTCCA
ATAGAGGTCCA -> TAGAGGTCCAT
TAGAGGTCCAT -> AGAGGTCCATC
AGAGGTCCATC -> GAGGTCCATCA
GAGGTCCATCA -> AGGTCCATCAG
AGGTCCATCAG -> GGTCCATCAGT
GGTCCATCAGT -> GTCCATCAGTG
GTCCATCAGTG -> TCCATCAGTGA
TCCATCAGTGA -> CCATCAGTGAC
CCATCAGTGAC -> CATCAGTGACG
CATCAGTGACG -> ATCAGTGACGC
ATCAGTGACGC -> TCAGTGACGCC
TCAGTGACGCC -> CAGTGACGCCC
CAGTGACGCCC -> AGTGACGCCCG
AGTGACGCCCG -> GTGACGCCCGA
GTGACGCCCGA -> TGACGCCCGAC
TGACGCCCGAC -> GACGCCCGACT
GACGCCCGACT -> ACGCCCGACTG
ACGCCCGACTG -> CGCCCGACTGA
CGCCCGACTGA -> GCCCGACTGAT
GCCCGACTGAT -> CCCGACTGATG
CCCGACTGATG -> CCGACTGATGT
CCGACTGATGT -> CGACTGATGTG
CGACTGATGTG -> GACTGATGTGG
GACTGATGTGG -> ACTGATGTGGC
ACTGATGTGGC -> CTGATGTGGCT
CTGATGTGGCT -> TGATGTGGCTT
TGATGTGGCTT -> GATGTGGCTTC
GATGTGGCTTC -> ATGTGGCTTCC
ATGTGGCTTCC -> TGTGGCTTCCG
TGTGGCTTCCG -> GTGGCTTCCGG
GTGGCTTCCGG -> TGGCTTCCGGT
TGGCTTCCGGT -> GGCTTCCGGTG
GGCTTCCGGTG -> GCTTCCGGTGG
GCTTCCGGTGG -> CTTCCGGTGGT
CTTCCGGTGGT -> TTCCGGTGGTG
TTCCGGTGGTG -> TCCGGTGGTGA
TCCGGTGGTGA -> CCGGTGGTGAT
CCGGTGGTGAT -> CGGTGGTGATT
CGGTGGTGATT -> GGTGGTGATTC
GGTGGTGATTC -> GTGGTGATTCC
GTGGTGATTCC -> TGGTGATTCCG
TGGTGATTCCG -> GGTGATTCCGG
GGTGATTCCGG -> GTGATTCCGGC
GTGATTCCGGC -> TGATTCCGGCG
TGATTCCGGCG -> GATTCCGGCGA
GATTCCGGCGA -> ATTCCGGCGAT
ATTCCGGCGAT -> TTCCGGCGATG
TTCCGGCGATG -> TCCGGCGATGC
TCCGGCGATGC -> CCGGCGATGCT
CCGGCGATGCT -> CGGCGATGCTA
CGGCGATGCTA -> GGCGATGCTAG
GGCGATGCTAG -> GCGATGCTAGA
GCGATGCTAGA -> CGATGCTAGAA
CGATGCTAGAA -> GATGCTAGAAC
GATGCTAGAAC -> ATGCTAGAACT
ATGCTAGAACT -> TGCTAGAACTC
TGCTAGAACTC -> GCTAGAACTCT
GCTAGAACTCT -> CTAGAACTCTA
CTAGAACTCTA -> TAGAACTCTAC
TAGAACTCTAC -> AGAACTCTACG
AGAACTCTACG -> GAACTCTACGT
GAACTCTACGT -> AACTCTACGTT
AACTCTACGTT -> ACTCTACGTTG
ACTCTACGTTG -> CTCTACGTTGA
CTCTACGTTGA -> TCTACGTTGAG
TCTACGTTGAG -> CTACGTTGAGG
CTACGTTGAGG -> TACGTTGAGGA
TACGTTGAGGA -> ACGTTGAGGAG
ACGTTGAGGAG -> CGTTGAGGAGA
CGTTGAGGAGA -> GTTGAGGAGAG
GTTGAGGAGAG -> TTGAGGAGAGA
TTGAGGAGAGA -> TGAGGAGAGAG
TGAGGAGAGAG -> GAGGAGAGAGC
GAGGAGAGAGC -> AGGAGAGAGCT
AGGAGAGAGCT -> GGAGAGAGCTA
GGAGAGAGCTA -> GAGAGAGCTAA
GAGAGAGCTAA -> AGAGAGCTAAC
AGAGAGCTAAC -> GAGAGCTAACC
GAGAGCTAACC -> AGAGCTAACCA
AGAGCTAACCA -> GAGCTAACCAC
GAGCTAACCAC -> AGCTAACCACT
AGCTAACCACT -> GCTAACCACTC
GCTAACCACTC -> CTAACCACTCG
CTAACCACTCG -> TAACCACTCGC
TAACCACTCGC -> AACCACTCGCT
AACCACTCGCT -> ACCACTCGCTA
ACCACTCGCTA -> CCACTCGCTAC
CCACTCGCTAC -> CACTCGCTACC
CACTCGCTACC -> ACTCGCTACCG
ACTCGCTACCG -> CTCGCTACCGG
CTCGCTACCGG -> TCGCTACCGGA
TCGCTACCGGA -> CGCTACCGGAG
CGCTACCGGAG -> GCTACCGGAGC
GCTACCGGAGC -> CTACCGGAGCA
CTACCGGAGCA -> TACCGGAGCAG
TACCGGAGCAG -> ACCGGAGCAGG
ACCGGAGCAGG -> CCGGAGCAGGC
CCGGAGCAGGC -> CGGAGCAGGCT
CGGAGCAGGCT -> GGAGCAGGCTT
GGAGCAGGCTT -> GAGCAGGCTTG
GAGCAGGCTTG -> AGCAGGCTTGT
AGCAGGCTTGT -> GCAGGCTTGTC
GCAGGCTTGTC -> CAGGCTTGTCC
CAGGCTTGTCC -> AGGCTTGTCCC
AGGCTTGTCCC -> GGCTTGTCCCG
GGCTTGTCCCG -> GCTTGTCCCGC
GCTTGTCCCGC -> CTTGTCCCGCG
CTTGTCCCGCG -> TTGTCCCGCGG
TTGTCCCGCGG -> TGTCCCGCGGG
TCCCGCGGGCA -> CCCGCGGGCAC
CCCGCGGGCAC -> CCGCGGGCACA
CCGCGGGCACA -> CGCGGGCACAG
CGCGGGCACAG -> GCGGGCACAGG
GCGGGCACAGG -> CGGGCACAGGG
CGGGCACAGGG -> GGGCACAGGGT
GGGCACAGGGT -> GGCACAGGGTG
GGCACAGGGTG -> GCACAGGGTGA
GCACAGGGTGA -> CACAGGGTGAT
CACAGGGTGAT -> ACAGGGTGATG
ACAGGGTGATG -> CAGGGTGATGA
CAGGGTGATGA -> AGGGTGATGAA
AGGGTGATGAA -> GGGTGATGAAG
GGGTGATGAAG -> GGTGATGAAGC
GGTGATGAAGC -> GTGATGAAGCT
GTGATGAAGCT -> TGATGAAGCTT
TGATGAAGCTT -> GATGAAGCTTT
GATGAAGCTTT -> ATGAAGCTTTC
ATGAAGCTTTC -> TGAAGCTTTCG
TGAAGCTTTCG -> GAAGCTTTCGG
GAAGCTTTCGG -> AAGCTTTCGGC
AAGCTTTCGGC -> AGCTTTCGGCG
AGCTTTCGGCG -> GCTTTCGGCGT
GCTTTCGGCGT -> CTTTCGGCGTC
CTTTCGGCGTC -> TTTCGGCGTCA
TTTCGGCGTCA -> TTCGGCGTCAC
TTCGGCGTCAC -> TCGGCGTCACA
TCGGCGTCACA -> CGGCGTCACAG
CGGCGTCACAG -> GGCGTCACAGC
GGCGTCACAGC -> GCGTCACAGCT
GCGTCACAGCT -> CGTCACAGCTG
CGTCACAGCTG -> GTCACAGCTGT
GTCACAGCTGT -> TCACAGCTGTT
TCACAGCTGTT -> CACAGCTGTTC
CACAGCTGTTC -> ACAGCTGTTCA
ACAGCTGTTCA -> CAGCTGTTCAC
CAGCTGTTCAC -> AGCTGTTCACA
AGCTGTTCACA -> GCTGTTCACAG
GCTGTTCACAG -> CTGTTCACAGT
CTGTTCACAGT -> TGTTCACAGTG
TGTTCACAGTG -> GTTCACAGTGA
GTTCACAGTGA -> TTCACAGTGAG
TTCACAGTGAG -> TCACAGTGAGT
TCACAGTGAGT -> CACAGTGAGTT
CACAGTGAGTT -> ACAGTGAGTTT
ACAGTGAGTTT -> CAGTGAGTTTG
CAGTGAGTTTG -> AGTGAGTTTGG
AGTGAGTTTGG -> GTGAGTTTGGG
GTGAGTTTGGG -> TGAGTTTGGGA
TGAGTTTGGGA -> GAGTTTGGGAT
GAGTTTGGGAT -> AGTTTGGGATG
AGTTTGGGATG -> GTTTGGGATGT
GTTTGGGATGT -> TTTGGGATGTA
TTTGGGATGTA -> TTGGGATGTAG
TTGGGATGTAG -> TGGGATGTAGA
TGGGATGTAGA -> GGGATGTAGAC
GGGATGTAGAC -> GGATGTAGACT
GGATGTAGACT -> GATGTAGACTT
GATGTAGACTT -> ATGTAGACTTG
ATGTAGACTTG -> TGTAGACTTGC
TGTAGACTTGC -> GTAGACTTGCG
GTAGACTTGCG -> TAGACTTGCGG
TAGACTTGCGG -> AGACTTGCGGG
AGACTTGCGGG -> GACTTGCGGGC
GACTTGCGGGC -> ACTTGCGGGCC
ACTTGCGGGCC -> CTTGCGGGCCT
CTTGCGGGCCT -> TTGCGGGCCTG
TTGCGGGCCTG -> TGCGGGCCTGG
TGCGGGCCTGG -> GCGGGCCTGGG
GCGGGCCTGGG -> CGGGCCTGGGT
CGGGCCTGGGT -> GGGCCTGGGTT
GGGCCTGGGTT -> GGCCTGGGTTT
GGCCTGGGTTT -> GCCTGGGTTTT
GCCTGGGTTTT -> CCTGGGTTTTG
CCTGGGTTTTG -> CTGGGTTTTGA
CTGGGTTTTGA -> TGGGTTTTGAT
TGGGTTTTGAT -> GGGTTTTGATG
GGGTTTTGATG -> GGTTTTGATGA
GGTTTTGATGA -> GTTTTGATGAC
GTTTTGATGAC -> TTTTGATGACT
TTTTGATGACT -> TTTGATGACTA
TTTGATGACTA -> TTGATGACTAA
TTGATGACTAA -> TGATGACTAAT
TGATGACTAAT -> GATGACTAATT
GATGACTAATT -> ATGACTAATTG
ATGACTAATTG -> TGACTAATTGC
TGACTAATTGC -> GACTAATTGCT
GACTAATTGCT -> ACTAATTGCTT
ACTAATTGCTT -> CTAATTGCTTA
CTAATTGCTTA -> TAATTGCTTAA
TAATTGCTTAA -> AATTGCTTAAA
AATTGCTTAAA -> ATTGCTTAAAA
ATTGCTTAAAA -> TTGCTTAAAAC
TTGCTTAAAAC -> TGCTTAAAACA
TGCTTAAAACA -> GCTTAAAACAC
GCTTAAAACAC -> CTTAAAACACC
CTTAAAACACC -> TTAAAACACCC
TTAAAACACCC -> TAAAACACCCC
TAAAACACCCC -> AAAACACCCCG
AAAACACCCCG -> AAACACCCCGC
AAACACCCCGC -> AACACCCCGCG
AACACCCCGCG -> ACACCCCGCGT
ACACCCCGCGT -> CACCCCGCGTG
CACCCCGCGTG -> ACCCCGCGTGC
ACCCCGCGTGC -> CCCCGCGTGCG
CCCCGCGTGCG -> CCCGCGTGCGC
CCCGCGTGCGC -> CCGCGTGCGCA
CCGCGTGCGCA -> CGCGTGCGCAG
CGCGTGCGCAG -> GCGTGCGCAGA
GCGTGCGCAGA -> CGTGCGCAGAA
CGTGCGCAGAA -> GTGCGCAGAAG
GTGCGCAGAAG -> TGCGCAGAAGC
TGCGCAGAAGC -> GCGCAGAAGCA
GCGCAGAAGCA -> CGCAGAAGCAG
CGCAGAAGCAG -> GCAGAAGCAGT
GCAGAAGCAGT -> CAGAAGCAGTG
CAGAAGCAGTG -> AGAAGCAGTGG
AGAAGCAGTGG -> GAAGCAGTGGA
GAAGCAGTGGA -> AAGCAGTGGAA
AAGCAGTGGAA -> AGCAGTGGAAA
AGCAGTGGAAA -> GCAGTGGAAAG
GCAGTGGAAAG -> CAGTGGAAAGA
CAGTGGAAAGA -> AGTGGAAAGAC
AGTGGAAAGAC -> GTGGAAAGACG
GTGGAAAGACG -> TGGAAAGACGG
TGGAAAGACGG -> GGAAAGACGGT
GGAAAGACGGT -> GAAAGACGGTC
GAAAGACGGTC -> AAAGACGGTCC
AAAGACGGTCC -> AAGACGGTCCC
AAGACGGTCCC -> AGACGGTCCCG
AGACGGTCCCG -> GACGGTCCCGC
GACGGTCCCGC -> ACGGTCCCGCA
ACGGTCCCGCA -> CGGTCCCGCAA
CGGTCCCGCAA -> GGTCCCGCAAA
GGTCCCGCAAA -> GTCCCGCAAAC
GTCCCGCAAAC -> TCCCGCAAACC
TCCCGCAAACC -> CCCGCAAACCT
CCCGCAAACCT -> CCGCAAACCTA
CCGCAAACCTA -> CGCAAACCTAG
CGCAAACCTAG -> GCAAACCTAGG
GCAAACCTAGG -> CAAACCTAGGA
CAAACCTAGGA -> AAACCTAGGAA
AAACCTAGGAA -> AACCTAGGAAC
AACCTAGGAAC -> ACCTAGGAACG
ACCTAGGAACG -> CCTAGGAACGT
CCTAGGAACGT -> CTAGGAACGTC
CTAGGAACGTC -> TAGGAACGTCA
TAGGAACGTCA -> AGGAACGTCAC
AGGAACGTCAC -> GGAACGTCACT
GGAACGTCACT -> GAACGTCACTC
GAACGTCACTC -> AACGTCACTCG
AACGTCACTCG -> ACGTCACTCGG
ACGTCACTCGG -> CGTCACTCGGT
CGTCACTCGGT -> GTCACTCGGTG
GTCACTCGGTG -> TCACTCGGTGT
TCACTCGGTGT -> CACTCGGTGTG
CACTCGGTGTG -> ACTCGGTGTGA
ACTCGGTGTGA -> CTCGGTGTGAT
CTCGGTGTGAT -> TCGGTGTGATT
TCGGTGTGATT -> CGGTGTGATTT
CGGTGTGATTT -> GGTGTGATTTC
GGTGTGATTTC -> GTGTGATTTCG
GTGTGATTTCG -> TGTGATTTCGC
TGTGATTTCGC -> GTGATTTCGCG
GTGATTTCGCG -> TGATTTCGCGA
TGATTTCGCGA -> GATTTCGCGAG
GATTTCGCGAG -> ATTTCGCGAGG
ATTTCGCGAGG -> TTTCGCGAGGG
TTTCGCGAGGG -> TTCGCGAGGGC
TTCGCGAGGGC -> TCGCGAGGGCT
TCGCGAGGGCT -> CGCGAGGGCTG
CGCGAGGGCTG -> GCGAGGGCTGA
GCGAGGGCTGA -> CGAGGGCTGAA
CGAGGGCTGAA -> GAGGGCTGAAG
GAGGGCTGAAG -> AGGGCTGAAGT
AGGGCTGAAGT -> GGGCTGAAGTT
GGGCTGAAGTT -> GGCTGAAGTTA
GGCTGAAGTTA -> GCTGAAGTTAT
GCTGAAGTTAT -> CTGAAGTTATT
CTGAAGTTATT -> TGAAGTTATTA
TGAAGTTATTA -> GAAGTTATTAG
GAAGTTATTAG -> AAGTTATTAGC
AAGTTATTAGC -> AGTTATTAGCA
AGTTATTAGCA -> GTTATTAGCAG
GTTATTAGCAG -> TTATTAGCAGG
TTATTAGCAGG -> TATTAGCAGGT
TATTAGCAGGT -> ATTAGCAGGTC
ATTAGCAGGTC -> TTAGCAGGTCG
TTAGCAGGTCG -> TAGCAGGTCGT
TAGCAGGTCGT -> AGCAGGTCGTT
AGCAGGTCGTT -> GCAGGTCGTTT
GCAGGTCGTTT -> CAGGTCGTTTT
CAGGTCGTTTT -> AGGTCGTTTTA
AGGTCGTTTTA -> GGTCGTTTTAC
GGTCGTTTTAC -> GTCGTTTTACG
GTCGTTTTACG -> TCGTTTTACGA
TCGTTTTACGA -> CGTTTTACGAA
CGTTTTACGAA -> GTTTTACGAAT
GTTTTACGAAT -> TTTTACGAATA
TTTTACGAATA -> TTTACGAATAT
TTTACGAATAT -> TTACGAATATT
TTACGAATATT -> TACGAATATTT
TACGAATATTT -> ACGAATATTTG
ACGAATATTTG -> CGAATATTTGG
CGAATATTTGG -> GAATATTTGGA
GAATATTTGGA -> AATATTTGGAC
AATATTTGGAC -> ATATTTGGACT
ATATTTGGACT -> TATTTGGACTG
TATTTGGACTG -> ATTTGGACTGC
ATTTGGACTGC -> TTTGGACTGCG
TTTGGACTGCG -> TTGGACTGCGC
TTGGACTGCGC -> TGGACTGCGCA
TGGACTGCGCA -> GGACTGCGCAC
GGACTGCGCAC -> GACTGCGCACG
GACTGCGCACG -> ACTGCGCACGG
ACTGCGCACGG -> CTGCGCACGGT
CTGCGCACGGT -> TGCGCACGGTG
TGCGCACGGTG -> GCGCACGGTGG
GCGCACGGTGG -> CGCACGGTGGG
CGCACGGTGGG -> GCACGGTGGGC
GCACGGTGGGC -> CACGGTGGGCC
CACGGTGGGCC -> ACGGTGGGCCC
ACGGTGGGCCC -> CGGTGGGCCCT
CGGTGGGCCCT -> GGTGGGCCCTC
GGTGGGCCCTC -> GTGGGCCCTCA
GTGGGCCCTCA -> TGGGCCCTCAT
TGGGCCCTCAT -> GGGCCCTCATA
GGGCCCTCATA -> GGCCCTCATAC
GGCCCTCATAC -> GCCCTCATACG
GCCCTCATACG -> CCCTCATACGG
CCCTCATACGG -> CCTCATACGGA
CCTCATACGGA -> CTCATACGGAG
CTCATACGGAG -> TCATACGGAGC
TCATACGGAGC -> CATACGGAGCG
CATACGGAGCG -> ATACGGAGCGT
ATACGGAGCGT -> TACGGAGCGTA
TACGGAGCGTA -> ACGGAGCGTAC
ACGGAGCGTAC -> CGGAGCGTACA
CGGAGCGTACA -> GGAGCGTACAC
GGAGCGTACAC -> GAGCGTACACT
GAGCGTACACT -> AGCGTACACTG
AGCGTACACTG -> GCGTACACTGC
GCGTACACTGC -> CGTACACTGCC
CGTACACTGCC -> GTACACTGCCT
GTACACTGCCT -> TACACTGCCTC
TACACTGCCTC -> ACACTGCCTCC
ACACTGCCTCC -> CACTGCCTCCC
CACTGCCTCCC -> ACTGCCTCCCG
ACTGCCTCCCG -> CTGCCTCCCGA
CTGCCTCCCGA -> TGCCTCCCGAG
TGCCTCCCGAG -> GCCTCCCGAGG
GCCTCCCGAGG -> CCTCCCGAGGA
CCTCCCGAGGA -> CTCCCGAGGAT
CTCCCGAGGAT -> TCCCGAGGATG
TCCCGAGGATG -> CCCGAGGATGC
CCCGAGGATGC -> CCGAGGATGCA
CCGAGGATGCA -> CGAGGATGCAC
CGAGGATGCAC -> GAGGATGCACT
GAGGATGCACT -> AGGATGCACTC
